seasonId,skaterFullName,totalFaceoffWins,totalFaceoffLosses,totalFaceoffs,gamesPlayed,game_type,percent_won,season_rank_pct,season_rank_tot
20002001,Ryan Johnson,465,486,951,80,2,0.4889589905362776,102.0,61.0
20002001,Shayne Corson,294,308,602,77,2,0.4883720930232558,103.0,96.0
20002001,Denis Pederson,150,201,351,61,2,0.42735042735042733,172.0,138.0
20002001,Brian Rolston,304,362,666,77,2,0.45645645645645644,138.0,95.0
20002001,Radek Bonk,771,735,1506,74,2,0.5119521912350598,75.0,18.0
20002001,Travis Green,623,512,1135,69,2,0.5488986784140969,29.0,39.0
20002001,Geoff Sanderson,356,370,726,68,2,0.4903581267217631,101.0,87.0
20002001,Keith Primeau,968,843,1811,71,2,0.5345113197128658,40.0,7.0
20002001,Brent Gilchrist,204,197,401,60,2,0.5087281795511222,79.0,124.0
20002001,Chris Gratton,665,496,1161,82,2,0.5727820844099913,11.0,34.0
20002001,Mike York,515,583,1098,79,2,0.4690346083788707,129.0,54.0
20002001,Vinny Prospal,517,471,988,74,2,0.5232793522267206,54.0,53.0
20002001,Denis Arkhipov,131,168,299,40,2,0.43812709030100333,159.0,145.0
20002001,Serge Aubin,691,655,1346,81,2,0.513372956909361,72.0,29.0
20002001,Per Svartvadet,383,519,902,69,2,0.4246119733924612,174.0,77.0
20002001,Doug Weight,777,737,1514,82,2,0.5132100396301189,73.0,17.0
20002001,Juha Ylonen,67,96,163,69,2,0.4110429447852761,183.0,170.0
20002001,Josef Vasicek,366,420,786,76,2,0.46564885496183206,133.0,83.0
20002001,Tom Fitzgerald,250,208,458,82,2,0.5458515283842795,31.0,111.0
20002001,Viktor Kozlov,340,477,817,51,2,0.41615667074663404,179.0,90.0
20002001,Mats Sundin,1059,811,1870,82,2,0.5663101604278075,15.0,4.0
20002001,Dave Andreychuk,93,94,187,74,2,0.49732620320855614,95.0,159.0
20002001,Mike Sillinger,750,493,1243,68,2,0.6033789219629928,4.0,21.0
20002001,Shaun Van Allen,263,296,559,59,2,0.47048300536672627,126.0,106.0
20002001,Len Barrie,267,261,528,60,2,0.5056818181818182,84.0,105.0
20002001,Ron Sutter,113,97,210,21,2,0.5380952380952381,37.0,151.0
20002001,Dainius Zubrus,78,112,190,61,2,0.4105263157894737,184.0,166.0
20002001,Aaron Gavey,254,330,584,75,2,0.4349315068493151,164.0,109.0
20002001,Dan Hinote,252,254,506,76,2,0.4980237154150198,94.0,110.0
20002001,Tyler Wright,450,549,999,76,2,0.45045045045045046,142.0,64.0
20002001,Shawn McEachern,205,215,420,82,2,0.4880952380952381,104.0,123.0
20002001,Wes Walz,723,810,1533,82,2,0.47162426614481406,123.0,24.0
20002001,Bryan Smolinski,464,488,952,78,2,0.48739495798319327,105.0,62.0
20002001,Rob Niedermayer,449,548,997,67,2,0.45035105315947843,143.0,65.0
20002001,Martin Lapointe,245,216,461,82,2,0.5314533622559653,43.0,114.0
20002001,Steve Martins,271,215,486,59,2,0.5576131687242798,24.0,102.0
20002001,Mike Sullivan,401,396,797,72,2,0.5031367628607277,89.0,73.0
20002001,Mike Eastwood,657,573,1230,77,2,0.5341463414634147,41.0,36.0
20002001,Alex Kovalev,102,153,255,79,2,0.4,191.0,155.0
20002001,Rod Brind'Amour,1152,755,1907,79,2,0.6040901940220241,3.0,2.0
20002001,Stephen Guolla,410,449,859,63,2,0.47729918509895225,118.0,71.0
20002001,Sergei Nemchinov,312,337,649,65,2,0.48073959938366717,112.0,93.0
20002001,Mike Ricci,839,792,1631,81,2,0.5144083384426732,70.0,12.0
20002001,Shean Donovan,100,118,218,63,2,0.45871559633027525,137.0,156.0
20002001,Scott Walker,278,263,541,74,2,0.5138632162661737,71.0,99.0
20002001,Denis Hamel,58,113,171,41,2,0.3391812865497076,195.0,174.0
20002001,Greg Classen,82,113,195,27,2,0.4205128205128205,177.0,163.0
20002001,Joe Thornton,860,791,1651,72,2,0.5208964264082374,58.0,10.0
20002001,Cliff Ronning,149,182,331,80,2,0.4501510574018127,144.0,139.0
20002001,Kirk Muller,274,265,539,55,2,0.5083487940630798,80.0,101.0
20002001,Brian Holzinger,367,408,775,70,2,0.4735483870967742,121.0,82.0
20002001,Roman Lyashenko,181,237,418,60,2,0.43301435406698563,165.0,129.0
20002001,David Legwand,358,530,888,81,2,0.40315315315315314,189.0,86.0
20002001,Cory Stillman,174,208,382,78,2,0.45549738219895286,139.0,130.0
20002001,Eric Belanger,479,370,849,62,2,0.5641931684334511,17.0,59.0
20002001,Bruce Gardiner,260,245,505,73,2,0.5148514851485149,69.0,108.0
20002001,Erik Rasmussen,247,318,565,82,2,0.43716814159292033,162.0,112.0
20002001,Jozef Stumpel,674,604,1278,63,2,0.5273865414710485,50.0,31.0
20002001,Chris Drury,304,248,552,71,2,0.5507246376811594,28.0,95.0
20002001,Brendan Morrison,844,841,1685,82,2,0.5008902077151335,91.0,11.0
20002001,Stacy Roest,417,314,731,76,2,0.5704514363885089,13.0,68.0
20002001,Daniel Bri√®re,105,105,210,30,2,0.5,92.0,154.0
20002001,Jeff Toms,80,113,193,54,2,0.41450777202072536,180.0,165.0
20002001,Wyatt Smith,137,198,335,42,2,0.408955223880597,185.0,144.0
20002001,Mats Lindgren,85,91,176,20,2,0.48295454545454547,110.0,162.0
20002001,Steve Reinprecht,387,498,885,80,2,0.43728813559322033,161.0,76.0
20002001,Marty McInnis,285,320,605,75,2,0.47107438016528924,124.0,97.0
20002001,Daniel Tkaczuk,85,112,197,19,2,0.43147208121827413,168.0,162.0
20002001,Patrik Stefan,358,476,834,66,2,0.4292565947242206,171.0,86.0
20002001,Steve Dubinsky,405,309,714,60,2,0.5672268907563025,14.0,72.0
20002001,Patrik Elias,64,91,155,82,2,0.4129032258064516,182.0,172.0
20002001,Andreas Karlsson,361,382,743,60,2,0.4858681022880215,107.0,85.0
20002001,Oleg Kvasha,274,353,627,62,2,0.4370015948963317,163.0,101.0
20002001,Chris Herperger,381,297,678,61,2,0.5619469026548672,19.0,79.0
20002001,Adam Oates,1081,755,1836,81,2,0.5887799564270153,8.0,3.0
20002001,Ray Ferraro,818,887,1705,81,2,0.4797653958944281,115.0,15.0
20002001,Trevor Letowski,335,391,726,77,2,0.46143250688705234,135.0,91.0
20002001,Tim Taylor,173,119,292,38,2,0.5924657534246576,7.0,131.0
20002001,Patrick Marleau,487,601,1088,81,2,0.4476102941176471,148.0,58.0
20002001,Kelly Buchberger,63,92,155,82,2,0.4064516129032258,187.0,173.0
20002001,Igor Korolev,242,327,569,73,2,0.4253075571177504,173.0,115.0
20002001,Peter White,564,474,1038,77,2,0.5433526011560693,33.0,47.0
20002001,Marcus Nilson,69,100,169,78,2,0.40828402366863903,186.0,169.0
20002001,Michael Nylander,500,536,1036,82,2,0.4826254826254826,111.0,56.0
20002001,Eric Landry,269,241,510,51,2,0.5274509803921569,49.0,104.0
20002001,Robert Kron,116,148,264,59,2,0.4393939393939394,156.0,149.0
20002001,Ron Francis,731,540,1271,82,2,0.5751376868607396,10.0,22.0
20002001,Jason Arnott,377,383,760,54,2,0.49605263157894736,98.0,80.0
20002001,Randy Robitaille,233,248,481,62,2,0.48440748440748443,108.0,117.0
20002001,Steve Rucchin,149,140,289,16,2,0.5155709342560554,68.0,139.0
20002001,Vincent Damphousse,541,486,1027,45,2,0.5267770204479065,51.0,51.0
20002001,Jeff Shantz,469,407,876,73,2,0.5353881278538812,39.0,60.0
20002001,Clarke Wilm,515,477,992,81,2,0.5191532258064516,62.0,54.0
20002001,Yanic Perreault,661,394,1055,76,2,0.6265402843601896,1.0,35.0
20002001,Trent Whitfield,270,250,520,61,2,0.5192307692307693,61.0,103.0
20002001,Harold Druken,262,336,598,55,2,0.43812709030100333,159.0,107.0
20002001,Bobby Holik,765,600,1365,80,2,0.5604395604395604,21.0,19.0
20002001,Sergei Fedorov,893,708,1601,75,2,0.5577763897564022,23.0,9.0
20002001,Manny Malhotra,110,138,248,50,2,0.4435483870967742,150.0,152.0
20002001,Claude Lapointe,541,533,1074,80,2,0.5037243947858473,88.0,51.0
20002001,Mike Stapleton,130,166,296,52,2,0.4391891891891892,157.0,146.0
20002001,Andrei Nikolishin,672,542,1214,81,2,0.5535420098846787,26.0,32.0
20002001,Dave Scatchard,729,593,1322,81,2,0.5514372163388804,27.0,23.0
20002001,Milan Kraft,162,265,427,42,2,0.3793911007025761,193.0,135.0
20002001,Scott Gomez,450,560,1010,76,2,0.44554455445544555,149.0,64.0
20002001,Mike Comrie,161,211,372,41,2,0.4327956989247312,166.0,136.0
20002001,Doug Gilmour,219,210,429,71,2,0.5104895104895105,77.0,119.0
20002001,Robert Lang,592,756,1348,82,2,0.4391691394658754,158.0,41.0
20002001,Mark Janssens,168,122,290,28,2,0.5793103448275863,9.0,132.0
20002001,German Titov,88,138,226,71,2,0.3893805309734513,192.0,160.0
20002001,Wayne Primeau,492,456,948,75,2,0.5189873417721519,63.0,57.0
20002001,Mike Modano,931,860,1791,81,2,0.519821328866555,59.0,8.0
20002001,Samuel Pahlsson,487,619,1106,76,2,0.4403254972875226,153.0,58.0
20002001,Joe Nieuwendyk,722,540,1262,69,2,0.572107765451664,12.0,25.0
20002001,Kent Manderville,389,424,813,82,2,0.4784747847478475,116.0,75.0
20002001,Marty Reasoner,241,213,454,41,2,0.5308370044052864,44.0,116.0
20002001,Dave Reid,142,210,352,73,2,0.4034090909090909,188.0,141.0
20002001,Craig Darby,569,645,1214,78,2,0.4686985172981878,130.0,46.0
20002001,Andrew Cassels,581,583,1164,66,2,0.4991408934707904,93.0,44.0
20002001,Petr Nedved,670,679,1349,79,2,0.4966641957005189,96.0,33.0
20002001,Peter Forsberg,352,403,755,73,2,0.46622516556291393,131.0,88.0
20002001,Martin Straka,143,188,331,82,2,0.43202416918429004,167.0,140.0
20002001,Greg Johnson,820,763,1583,82,2,0.5180037902716361,65.0,14.0
20002001,Michal Handzus,361,331,692,46,2,0.5216763005780347,55.0,85.0
20002001,Kevyn Adams,755,595,1350,78,2,0.5592592592592592,22.0,20.0
20002001,Doug Brown,123,111,234,60,2,0.5256410256410257,52.0,147.0
20002001,Saku Koivu,520,572,1092,54,2,0.47619047619047616,119.0,52.0
20002001,Darby Hendrickson,506,613,1119,72,2,0.45218945487042,141.0,55.0
20002001,Daniel Corso,166,130,296,28,2,0.5608108108108109,20.0,133.0
20002001,Stu Barnes,710,760,1470,75,2,0.48299319727891155,109.0,28.0
20002001,Tommy Vestlund,173,167,340,79,2,0.5088235294117647,78.0,131.0
20002001,Matt Cullen,710,768,1478,82,2,0.4803788903924222,114.0,28.0
20002001,Jamie Langenbrunner,143,173,316,53,2,0.4525316455696203,140.0,140.0
20002001,Jan Bulis,216,238,454,51,2,0.47577092511013214,120.0,120.0
20002001,Jeff Halpern,677,616,1293,80,2,0.5235885537509667,53.0,30.0
20002001,Josef Marha,98,98,196,15,2,0.5,92.0,158.0
20002001,Jochen Hecht,70,90,160,72,2,0.4375,160.0,168.0
20002001,Brian Swanson,66,84,150,16,2,0.44,155.0,171.0
20002001,Domenic Pittis,201,166,367,47,2,0.547683923705722,30.0,126.0
20002001,Chad Kilger,376,334,710,77,2,0.5295774647887324,47.0,81.0
20002001,Shawn Bates,209,204,413,45,2,0.5060532687651331,83.0,121.0
20002001,Curtis Brown,584,575,1159,70,2,0.5038826574633305,87.0,43.0
20002001,Nik Antropov,191,240,431,52,2,0.4431554524361949,151.0,128.0
20002001,Mario Lemieux,444,408,852,43,2,0.5211267605633803,57.0,66.0
20002001,Steve Yzerman,713,484,1197,54,2,0.595655806182122,5.0,27.0
20002001,Jim Montgomery,99,108,207,28,2,0.4782608695652174,117.0,157.0
20002001,Mark Messier,1043,836,1879,82,2,0.5550824906865354,25.0,5.0
20002001,Mike Fisher,356,353,709,60,2,0.5021156558533145,90.0,87.0
20002001,Vincent Lecavalier,574,704,1278,68,2,0.4491392801251956,146.0,45.0
20002001,Jarome Iginla,330,308,638,77,2,0.5172413793103449,67.0,92.0
20002001,Alexei Zhamnov,714,772,1486,63,2,0.48048452220726784,113.0,26.0
20002001,John Madden,454,520,974,80,2,0.46611909650924027,132.0,63.0
20002001,Owen Nolan,191,216,407,57,2,0.4692874692874693,128.0,128.0
20002001,Derek Plante,86,91,177,12,2,0.4858757062146893,106.0,161.0
20002001,Bob Corkum,631,539,1170,75,2,0.5393162393162393,35.0,38.0
20002001,Matt Cooke,138,183,321,81,2,0.42990654205607476,170.0,143.0
20002001,Joe Sakic,1214,1078,2292,82,2,0.5296684118673648,46.0,1.0
20002001,Jan Hrdina,574,493,1067,78,2,0.5379568884723523,38.0,45.0
20002001,Pavel Patera,81,103,184,20,2,0.44021739130434784,154.0,164.0
20002001,Rob Zamuner,58,104,162,79,2,0.35802469135802467,194.0,174.0
20002001,Ian Laperriere,154,143,297,79,2,0.5185185185185185,64.0,137.0
20002001,Jeff O'Neill,363,363,726,82,2,0.5,92.0,84.0
20002001,Todd Marchant,834,715,1549,71,2,0.5384118786313751,36.0,13.0
20002001,Henrik Sedin,450,570,1020,82,2,0.4411764705882353,152.0,64.0
20002001,Sergei Zholtok,232,195,427,69,2,0.5433255269320844,34.0,118.0
20002001,Jason Wiemer,306,293,599,65,2,0.5108514190317195,76.0,94.0
20002001,Trevor Linden,647,570,1217,69,2,0.5316351684470009,42.0,37.0
20002001,Steve Sullivan,275,374,649,81,2,0.423728813559322,175.0,100.0
20002001,Daymond Langkow,557,624,1181,71,2,0.47163420829805247,122.0,49.0
20002001,Marc Savard,557,493,1050,77,2,0.5304761904761904,45.0,49.0
20002001,Josef Beranek,77,95,172,70,2,0.4476744186046512,147.0,167.0
20002001,Jason Allison,985,912,1897,82,2,0.5192409066947812,60.0,6.0
20002001,Tony Hrkac,543,529,1072,80,2,0.5065298507462687,82.0,50.0
20002001,Roman Simicek,93,114,207,57,2,0.4492753623188406,145.0,159.0
20002001,Stephane Yelle,415,321,736,50,2,0.563858695652174,18.0,69.0
20002001,Jim Dowd,585,569,1154,68,2,0.5069324090121318,81.0,42.0
20002001,Pierre Turgeon,779,790,1569,79,2,0.4964945825366475,97.0,16.0
20002001,Keith Tkachuk,382,351,733,76,2,0.5211459754433834,56.0,78.0
20002001,Todd Warriner,202,198,400,64,2,0.505,85.0,125.0
20002001,Jamal Mayers,140,133,273,77,2,0.5128205128205128,74.0,142.0
20002001,Brad Isbister,117,138,255,51,2,0.4588235294117647,136.0,148.0
20002001,Rem Murray,342,352,694,82,2,0.49279538904899134,99.0,89.0
20002001,Craig Conroy,541,452,993,83,2,0.5448136958710977,32.0,51.0
20002001,Marco Sturm,208,309,517,81,2,0.402321083172147,190.0,122.0
20002001,Tim Connolly,412,577,989,82,2,0.416582406471183,178.0,70.0
20002001,Jarrod Skalde,137,154,291,19,2,0.47079037800687284,125.0,144.0
20002001,Mark Smith,163,145,308,42,2,0.5292207792207793,48.0,134.0
20002001,Igor Larionov,284,326,610,65,2,0.46557377049180326,134.0,98.0
20002001,Marc Chouinard,252,162,414,44,2,0.6086956521739131,2.0,110.0
20002001,Brad Richards,395,560,955,82,2,0.41361256544502617,181.0,74.0
20002001,Jeremy Roenick,436,452,888,80,2,0.49099099099099097,100.0,67.0
20002001,Olli Jokinen,270,368,638,78,2,0.4231974921630094,176.0,103.0
20002001,Sebastien Bordeleau,114,78,192,14,2,0.59375,6.0,150.0
20002001,John Emmons,246,229,475,53,2,0.5178947368421053,66.0,113.0
20002001,Joe Juneau,106,104,210,69,2,0.5047619047619047,86.0,153.0
20002001,Darcy Tucker,194,219,413,82,2,0.46973365617433416,127.0,127.0
20002001,Kris Draper,563,434,997,75,2,0.5646940822467402,16.0,48.0
20002001,Alexei Yashin,610,804,1414,82,2,0.4314002828854314,169.0,40.0
20002001,Shayne Corson,27,41,68,11,3,0.39705882352941174,67.0,51.0
20002001,Chris Gratton,107,73,180,13,3,0.5944444444444444,7.0,18.0
20002001,Keith Primeau,55,63,118,4,3,0.4661016949152542,50.0,37.0
20002001,Dan Hinote,20,16,36,23,3,0.5555555555555556,15.0,58.0
20002001,Jason Arnott,162,178,340,23,3,0.4764705882352941,45.0,8.0
20002001,Milan Kraft,51,43,94,8,3,0.5425531914893617,21.0,40.0
20002001,Mike Comrie,24,23,47,6,3,0.5106382978723404,30.0,54.0
20002001,Scott Gomez,147,169,316,25,3,0.4651898734177215,51.0,11.0
20002001,Joe Nieuwendyk,89,60,149,7,3,0.5973154362416108,6.0,24.0
20002001,Kent Manderville,36,45,81,6,3,0.4444444444444444,57.0,46.0
20002001,Marty Reasoner,22,29,51,10,3,0.43137254901960786,61.0,56.0
20002001,Bob Corkum,41,31,72,12,3,0.5694444444444444,12.0,44.0
20002001,Peter Forsberg,47,73,120,11,3,0.39166666666666666,70.0,42.0
20002001,Daniel Corso,37,30,67,12,3,0.5522388059701493,17.0,45.0
20002001,Tommy Vestlund,29,20,49,6,3,0.5918367346938775,9.0,50.0
20002001,Jamie Langenbrunner,23,35,58,10,3,0.39655172413793105,68.0,55.0
20002001,Stu Barnes,124,135,259,13,3,0.47876447876447875,44.0,15.0
20002001,Trevor Linden,55,33,88,6,3,0.625,3.0,37.0
20002001,Jeff Halpern,52,63,115,6,3,0.45217391304347826,55.0,39.0
20002001,Jochen Hecht,12,20,32,15,3,0.375,73.0,66.0
20002001,Curtis Brown,190,142,332,13,3,0.572289156626506,10.0,5.0
20002001,Mario Lemieux,167,193,360,18,3,0.4638888888888889,53.0,6.0
20002001,John Madden,94,146,240,25,3,0.39166666666666666,70.0,23.0
20002001,Mike Fisher,25,28,53,4,3,0.4716981132075472,49.0,53.0
20002001,Derek Plante,31,44,75,5,3,0.41333333333333333,65.0,48.0
20002001,Owen Nolan,21,20,41,6,3,0.5121951219512195,29.0,57.0
20002001,Joe Sakic,257,173,430,21,3,0.5976744186046512,5.0,2.0
20002001,Jan Hrdina,87,67,154,18,3,0.564935064935065,13.0,26.0
20002001,Ian Laperriere,23,23,46,13,3,0.5,35.0,55.0
20002001,Todd Marchant,99,74,173,6,3,0.5722543352601156,11.0,20.0
20002001,Henrik Sedin,18,38,56,4,3,0.32142857142857145,75.0,60.0
20002001,Daymond Langkow,54,70,124,6,3,0.43548387096774194,59.0,38.0
20002001,Stephane Yelle,201,169,370,23,3,0.5432432432432432,20.0,4.0
20002001,Pierre Turgeon,154,150,304,15,3,0.506578947368421,32.0,9.0
20002001,Jamal Mayers,60,48,108,15,3,0.5555555555555556,15.0,35.0
20002001,Jozef Stumpel,154,167,321,13,3,0.4797507788161994,43.0,9.0
20002001,Chris Drury,213,200,413,23,3,0.5157384987893463,28.0,3.0
20002001,Bryan Smolinski,144,146,290,13,3,0.496551724137931,38.0,12.0
20002001,Igor Korolev,63,97,160,11,3,0.39375,69.0,33.0
20002001,Peter White,22,18,40,3,3,0.55,18.0,56.0
20002001,Vincent Damphousse,65,76,141,6,3,0.46099290780141844,54.0,32.0
20002001,Robert Lang,138,193,331,16,3,0.4169184290030212,64.0,14.0
20002001,Adam Oates,78,36,114,6,3,0.6842105263157895,1.0,27.0
20002001,Wayne Primeau,148,165,313,18,3,0.4728434504792332,48.0,10.0
20002001,Mats Sundin,141,123,264,11,3,0.5340909090909091,24.0,13.0
20002001,Brendan Morrison,62,58,120,4,3,0.5166666666666667,27.0,34.0
20002001,Mike Sillinger,32,22,54,4,3,0.5925925925925926,8.0,47.0
20002001,Kirk Muller,78,71,149,10,3,0.5234899328859061,26.0,27.0
20002001,Igor Larionov,17,21,38,6,3,0.4473684210526316,56.0,61.0
20002001,Doug Gilmour,98,99,197,13,3,0.49746192893401014,36.0,21.0
20002001,Steve Reinprecht,96,93,189,22,3,0.5079365079365079,31.0,22.0
20002001,Denis Pederson,31,28,59,4,3,0.5254237288135594,25.0,48.0
20002001,Sergei Nemchinov,45,66,111,25,3,0.40540540540540543,66.0,43.0
20002001,Mike Ricci,67,58,125,6,3,0.536,23.0,31.0
20002001,Mike Eastwood,163,166,329,15,3,0.49544072948328266,39.0,7.0
20002001,Alex Kovalev,12,20,32,18,3,0.375,73.0,66.0
20002001,Cory Stillman,30,33,63,15,3,0.47619047619047616,46.0,49.0
20002001,Rod Brind'Amour,102,56,158,6,3,0.6455696202531646,2.0,19.0
20002001,Benoit Hogue,14,19,33,7,3,0.42424242424242425,63.0,64.0
20002001,Eric Belanger,119,117,236,13,3,0.5042372881355932,34.0,16.0
20002001,Mike Modano,110,115,225,9,3,0.4888888888888889,41.0,17.0
20002001,Alyn McCauley,49,50,99,10,3,0.494949494949495,40.0,41.0
20002001,Shaun Van Allen,36,47,83,8,3,0.43373493975903615,60.0,46.0
20002001,Doug Weight,59,68,127,6,3,0.4645669291338583,52.0,36.0
20002001,Keith Tkachuk,71,79,150,15,3,0.47333333333333333,47.0,28.0
20002001,Martin Lapointe,16,25,41,6,3,0.3902439024390244,71.0,62.0
20002001,Todd Harvey,15,16,31,6,3,0.4838709677419355,42.0,63.0
20002001,Steve Kelly,17,23,40,8,3,0.425,62.0,61.0
20002001,Yanic Perreault,69,42,111,11,3,0.6216216216216216,4.0,29.0
20002001,Trent Whitfield,19,15,34,5,3,0.5588235294117647,14.0,59.0
20002001,Josef Vasicek,26,33,59,6,3,0.4406779661016949,58.0,52.0
20002001,Alex Tanguay,21,33,54,23,3,0.3888888888888889,72.0,57.0
20002001,Patrik Elias,13,39,52,25,3,0.25,76.0,65.0
20002001,Sergei Fedorov,88,89,177,6,3,0.4971751412429379,37.0,25.0
20002001,Patrick Marleau,31,55,86,6,3,0.36046511627906974,74.0,48.0
20002001,Bobby Holik,269,218,487,25,3,0.5523613963039015,16.0,1.0
20002001,Milan Hejduk,29,20,49,23,3,0.5918367346938775,9.0,50.0
20002001,Andrei Nikolishin,47,40,87,6,3,0.5402298850574713,22.0,42.0
20002001,Kris Draper,68,56,124,6,3,0.5483870967741935,19.0,30.0
20002001,Alexei Yashin,49,48,97,4,3,0.5051546391752577,33.0,41.0
20012002,Shayne Corson,272,326,598,74,2,0.45484949832775917,149.0,108.0
20012002,Doug Gilmour,634,607,1241,70,2,0.5108783239323127,73.0,38.0
20012002,Dmitri Khristich,288,333,621,61,2,0.463768115942029,141.0,102.0
20012002,Geoff Sanderson,138,184,322,42,2,0.42857142857142855,174.0,140.0
20012002,Keith Primeau,818,777,1595,75,2,0.5128526645768025,72.0,16.0
20012002,Chris Gratton,698,599,1297,82,2,0.5381649961449498,33.0,28.0
20012002,Mike Sillinger,1154,870,2024,80,2,0.5701581027667985,11.0,2.0
20012002,Denis Arkhipov,496,612,1108,82,2,0.44765342960288806,156.0,56.0
20012002,Travis Green,350,297,647,82,2,0.5409582689335394,31.0,89.0
20012002,Dan Hinote,137,130,267,58,2,0.5131086142322098,71.0,141.0
20012002,Tyler Wright,455,581,1036,77,2,0.4391891891891892,165.0,67.0
20012002,Wes Walz,552,679,1231,64,2,0.44841592201462227,155.0,47.0
20012002,Shawn McEachern,110,100,210,80,2,0.5238095238095238,58.0,148.0
20012002,Ron Francis,669,467,1136,80,2,0.5889084507042254,4.0,31.0
20012002,Harold Druken,147,122,269,27,2,0.5464684014869888,24.0,137.0
20012002,Scott Gomez,306,322,628,76,2,0.4872611464968153,104.0,99.0
20012002,Marty McInnis,157,197,354,79,2,0.4435028248587571,161.0,131.0
20012002,Mike Comrie,567,631,1198,82,2,0.4732888146911519,127.0,46.0
20012002,Pavel Datsyuk,379,415,794,70,2,0.47732997481108314,120.0,82.0
20012002,Milan Kraft,342,424,766,68,2,0.4464751958224543,158.0,92.0
20012002,Todd Bertuzzi,74,77,151,72,2,0.4900662251655629,101.0,161.0
20012002,Espen Knutsen,232,268,500,77,2,0.464,140.0,115.0
20012002,Igor Korolev,479,687,1166,82,2,0.41080617495711835,183.0,61.0
20012002,Trent Whitfield,111,96,207,25,2,0.5362318840579711,39.0,147.0
20012002,Pierre Turgeon,398,424,822,66,2,0.48418491484184917,112.0,78.0
20012002,Pavol Demitra,589,635,1224,82,2,0.4812091503267974,116.0,44.0
20012002,Joe Juneau,650,687,1337,70,2,0.48616305160807777,109.0,36.0
20012002,Shawn Horcoff,210,244,454,61,2,0.46255506607929514,144.0,119.0
20012002,Andrew Cassels,436,430,866,53,2,0.5034642032332564,83.0,71.0
20012002,Dave Andreychuk,738,655,1393,82,2,0.529791816223977,51.0,24.0
20012002,Trevor Linden,670,591,1261,80,2,0.5313243457573354,47.0,30.0
20012002,Kent Manderville,104,131,235,38,2,0.4425531914893617,163.0,151.0
20012002,Petr Nedved,730,672,1402,78,2,0.5206847360912982,62.0,26.0
20012002,Benoit Hogue,89,91,180,58,2,0.49444444444444446,94.0,155.0
20012002,Trevor Letowski,180,181,361,75,2,0.4986149584487535,88.0,122.0
20012002,Vinny Prospal,293,262,555,81,2,0.527927927927928,53.0,101.0
20012002,Steve Yzerman,690,492,1182,52,2,0.583756345177665,6.0,29.0
20012002,Shaun Van Allen,276,282,558,73,2,0.4946236559139785,93.0,106.0
20012002,Mark Messier,422,365,787,41,2,0.5362134688691232,40.0,74.0
20012002,Jozef Stumpel,748,762,1510,81,2,0.495364238410596,92.0,23.0
20012002,Bob Corkum,710,665,1375,75,2,0.5163636363636364,69.0,27.0
20012002,Yanic Perreault,910,575,1485,82,2,0.6127946127946128,1.0,12.0
20012002,Manny Malhotra,192,239,431,72,2,0.44547563805104406,160.0,121.0
20012002,Jamal Mayers,400,361,761,77,2,0.5256241787122208,55.0,77.0
20012002,Wayne Primeau,276,243,519,33,2,0.5317919075144508,45.0,106.0
20012002,Marc Chouinard,319,262,581,45,2,0.5490533562822719,21.0,96.0
20012002,Eric Lindros,929,778,1707,72,2,0.5442296426479203,29.0,8.0
20012002,Jeff Halpern,370,291,661,48,2,0.5597579425113465,16.0,87.0
20012002,Vincent Lecavalier,386,545,931,76,2,0.4146079484425349,181.0,81.0
20012002,Jarome Iginla,170,138,308,82,2,0.551948051948052,19.0,125.0
20012002,Peter White,272,241,513,48,2,0.530214424951267,49.0,108.0
20012002,Ray Ferraro,515,585,1100,76,2,0.4681818181818182,133.0,52.0
20012002,Steve Sullivan,371,387,758,78,2,0.4894459102902375,103.0,86.0
20012002,Marc Savard,316,261,577,56,2,0.5476603119584056,23.0,97.0
20012002,Randy Robitaille,347,312,659,58,2,0.5265553869499241,54.0,90.0
20012002,Tim Taylor,305,254,559,48,2,0.5456171735241503,26.0,100.0
20012002,Martin Lapointe,119,103,222,68,2,0.536036036036036,41.0,145.0
20012002,Greg Johnson,914,850,1764,82,2,0.518140589569161,67.0,11.0
20012002,Matt Cullen,660,623,1283,79,2,0.514419329696025,70.0,32.0
20012002,Tim Connolly,425,649,1074,82,2,0.3957169459962756,187.0,72.0
20012002,Jiri Dopita,343,362,705,52,2,0.48652482269503544,108.0,91.0
20012002,Ryan Johnson,161,175,336,29,2,0.4791666666666667,119.0,129.0
20012002,Mario Lemieux,158,196,354,24,2,0.4463276836158192,159.0,130.0
20012002,Shawn Bates,151,155,306,71,2,0.4934640522875817,95.0,136.0
20012002,Colin Forbes,113,140,253,38,2,0.44664031620553357,157.0,146.0
20012002,Mike Fisher,413,435,848,58,2,0.48702830188679247,105.0,75.0
20012002,Anson Carter,147,169,316,82,2,0.4651898734177215,138.0,137.0
20012002,Joe Sakic,1122,1026,2148,82,2,0.5223463687150838,59.0,3.0
20012002,Jan Hrdina,336,331,667,79,2,0.5037481259370314,82.0,94.0
20012002,Henrik Sedin,372,413,785,82,2,0.47388535031847134,125.0,85.0
20012002,Stephane Yelle,537,499,1036,73,2,0.5183397683397684,66.0,50.0
20012002,Brad Richards,375,536,911,82,2,0.411635565312843,182.0,84.0
20012002,Dan Bylsma,109,148,257,77,2,0.42412451361867703,177.0,149.0
20012002,Byron Ritchie,169,164,333,35,2,0.5075075075075075,78.0,126.0
20012002,Rob Niedermayer,376,401,777,57,2,0.4839124839124839,113.0,83.0
20012002,Stu Barnes,464,520,984,68,2,0.4715447154471545,130.0,64.0
20012002,Brad Chartrand,256,225,481,46,2,0.5322245322245323,43.0,111.0
20012002,Alexei Zhamnov,817,817,1634,77,2,0.5,85.0,17.0
20012002,John Madden,470,531,1001,82,2,0.4695304695304695,132.0,63.0
20012002,Jason Arnott,486,525,1011,73,2,0.4807121661721068,117.0,60.0
20012002,Chris Herperger,379,390,769,72,2,0.4928478543563069,96.0,82.0
20012002,Kris Beech,273,331,604,79,2,0.4519867549668874,151.0,107.0
20012002,Todd Marchant,798,725,1523,82,2,0.5239658568614577,57.0,19.0
20012002,Jim Dowd,658,585,1243,82,2,0.5293644408688657,52.0,33.0
20012002,Sergei Zholtok,375,448,823,73,2,0.4556500607533414,147.0,84.0
20012002,Mark Smith,199,169,368,49,2,0.5407608695652174,32.0,120.0
20012002,John Emmons,87,66,153,22,2,0.5686274509803921,12.0,156.0
20012002,Marty Murray,463,450,913,74,2,0.5071193866374589,79.0,65.0
20012002,Scott Nichol,243,215,458,60,2,0.5305676855895196,48.0,113.0
20012002,Daniel Corso,232,191,423,41,2,0.5484633569739953,22.0,115.0
20012002,Darby Hendrickson,575,631,1206,68,2,0.4767827529021559,121.0,45.0
20012002,Curtis Brown,788,820,1608,82,2,0.4900497512437811,102.0,20.0
20012002,Chad Kilger,192,165,357,75,2,0.5378151260504201,36.0,121.0
20012002,Owen Nolan,256,289,545,75,2,0.46972477064220186,131.0,111.0
20012002,Pascal Rheaume,319,356,675,61,2,0.4725925925925926,129.0,96.0
20012002,Jeff O'Neill,471,360,831,76,2,0.5667870036101083,13.0,62.0
20012002,Steve Dubinsky,153,118,271,29,2,0.5645756457564576,14.0,135.0
20012002,Michael Peca,946,858,1804,80,2,0.524390243902439,56.0,7.0
20012002,Jason Allison,925,773,1698,73,2,0.5447585394581861,28.0,9.0
20012002,Alyn McCauley,457,494,951,82,2,0.480546792849632,118.0,66.0
20012002,Olli Jokinen,552,670,1222,80,2,0.45171849427168576,152.0,47.0
20012002,Brian Rolston,600,689,1289,82,2,0.46547711404189296,137.0,41.0
20012002,Radek Bonk,780,750,1530,82,2,0.5098039215686274,76.0,21.0
20012002,Tom Fitzgerald,309,326,635,78,2,0.48661417322834644,106.0,98.0
20012002,Josef Vasicek,424,454,878,78,2,0.48291571753986334,114.0,73.0
20012002,Mats Sundin,1041,771,1812,82,2,0.5745033112582781,9.0,5.0
20012002,Viktor Kozlov,362,478,840,50,2,0.430952380952381,172.0,88.0
20012002,Serge Aubin,394,386,780,71,2,0.5051282051282051,80.0,79.0
20012002,Per Svartvadet,156,191,347,78,2,0.4495677233429395,154.0,132.0
20012002,Andreas Johansson,129,170,299,70,2,0.431438127090301,170.0,143.0
20012002,Alexei Yashin,387,441,828,78,2,0.4673913043478261,134.0,80.0
20012002,Doug Weight,552,571,1123,61,2,0.4915405164737311,97.0,47.0
20012002,Theo Fleury,81,89,170,82,2,0.4764705882352941,122.0,159.0
20012002,Mike York,171,196,367,81,2,0.4659400544959128,136.0,124.0
20012002,Rob Valicevic,69,97,166,17,2,0.41566265060240964,180.0,163.0
20012002,Jan Bulis,67,89,156,53,2,0.42948717948717946,173.0,164.0
20012002,Sergei Nemchinov,212,285,497,68,2,0.42655935613682094,175.0,118.0
20012002,Mike Ricci,736,765,1501,79,2,0.49033977348434377,100.0,25.0
20012002,Aaron Gavey,108,146,254,71,2,0.4251968503937008,176.0,150.0
20012002,Andreas Karlsson,174,212,386,42,2,0.45077720207253885,153.0,123.0
20012002,Chris Drury,606,533,1139,82,2,0.5320456540825286,44.0,39.0
20012002,Bryan Smolinski,601,715,1316,80,2,0.4566869300911854,146.0,40.0
20012002,Sean Pronger,87,80,167,26,2,0.5209580838323353,61.0,156.0
20012002,Rem Murray,498,478,976,80,2,0.5102459016393442,75.0,55.0
20012002,Brendan Morrison,652,655,1307,82,2,0.49885233358837033,86.0,35.0
20012002,Jeremy Roenick,653,676,1329,75,2,0.49134687735139204,98.0,34.0
20012002,Oleg Kvasha,216,240,456,71,2,0.47368421052631576,126.0,116.0
20012002,Craig Conroy,898,756,1654,81,2,0.5429262394195888,30.0,13.0
20012002,Greg Classen,168,221,389,55,2,0.4318766066838046,169.0,127.0
20012002,Mike Sullivan,123,131,254,42,2,0.484251968503937,111.0,144.0
20012002,Jeff Daniels,83,95,178,65,2,0.46629213483146065,135.0,158.0
20012002,Samuel Pahlsson,598,603,1201,80,2,0.49791840133222315,89.0,42.0
20012002,Bobby Holik,869,725,1594,81,2,0.5451693851944793,27.0,14.0
20012002,Sergei Fedorov,600,560,1160,81,2,0.5172413793103449,68.0,41.0
20012002,Patrick Marleau,424,473,897,79,2,0.47268673355629875,128.0,73.0
20012002,Michal Handzus,597,630,1227,79,2,0.48655256723716384,107.0,43.0
20012002,Stacy Roest,277,227,504,58,2,0.5496031746031746,20.0,105.0
20012002,Daniel Bri√®re,493,458,951,78,2,0.5184016824395373,64.0,58.0
20012002,Toby Petersen,154,184,338,79,2,0.4556213017751479,148.0,134.0
20012002,Kevyn Adams,441,318,759,77,2,0.5810276679841897,7.0,69.0
20012002,Steve Rucchin,422,386,808,38,2,0.5222772277227723,60.0,74.0
20012002,Sean Avery,155,144,299,36,2,0.5183946488294314,65.0,133.0
20012002,Joe Thornton,658,683,1341,66,2,0.4906785980611484,99.0,33.0
20012002,Jason Williams,99,109,208,25,2,0.47596153846153844,123.0,152.0
20012002,Juha Ylonen,280,368,648,80,2,0.43209876543209874,168.0,104.0
20012002,Jason Wiemer,547,694,1241,70,2,0.44077356970185333,164.0,48.0
20012002,Jeff Toms,139,175,314,52,2,0.4426751592356688,162.0,139.0
20012002,Cory Stillman,91,105,196,80,2,0.4642857142857143,139.0,154.0
20012002,Mike Eastwood,597,513,1110,71,2,0.5378378378378378,35.0,43.0
20012002,Alex Kovalev,81,98,179,67,2,0.45251396648044695,150.0,159.0
20012002,Vincent Damphousse,843,847,1690,82,2,0.49881656804733726,87.0,15.0
20012002,Joe Nieuwendyk,953,667,1620,81,2,0.5882716049382716,5.0,6.0
20012002,Rob Zamuner,80,112,192,66,2,0.4166666666666667,179.0,160.0
20012002,Jeff Shantz,158,140,298,40,2,0.5302013422818792,50.0,130.0
20012002,Kirk Muller,254,257,511,78,2,0.49706457925636005,90.0,112.0
20012002,Tony Hrkac,444,491,935,80,2,0.4748663101604278,124.0,68.0
20012002,Mats Lindgren,140,97,237,59,2,0.5907172995780591,3.0,138.0
20012002,Todd White,761,747,1508,81,2,0.5046419098143236,81.0,22.0
20012002,Brett Harkins,69,91,160,25,2,0.43125,171.0,163.0
20012002,Claude Lapointe,495,412,907,80,2,0.545755237045204,25.0,57.0
20012002,Brent Gilchrist,132,127,259,45,2,0.5096525096525096,77.0,142.0
20012002,Marcus Nilson,236,303,539,81,2,0.437847866419295,166.0,114.0
20012002,Marty Reasoner,261,209,470,52,2,0.5553191489361702,18.0,110.0
20012002,Michael Nylander,489,485,974,82,2,0.502053388090349,84.0,59.0
20012002,Igor Larionov,283,370,653,70,2,0.4333843797856049,167.0,103.0
20012002,Denis Pederson,166,178,344,48,2,0.48255813953488375,115.0,128.0
20012002,Patrik Stefan,263,365,628,59,2,0.41878980891719747,178.0,109.0
20012002,Todd Harvey,108,115,223,69,2,0.484304932735426,110.0,150.0
20012002,Clarke Wilm,508,487,995,66,2,0.5105527638190954,74.0,54.0
20012002,Dave Scatchard,424,364,788,80,2,0.5380710659898477,34.0,73.0
20012002,Andrei Nikolishin,805,640,1445,80,2,0.5570934256055363,17.0,18.0
20012002,David Legwand,341,502,843,63,2,0.4045077105575326,184.0,93.0
20012002,Rod Brind'Amour,1218,840,2058,81,2,0.5918367346938775,2.0,1.0
20012002,Andy McDonald,439,379,818,53,2,0.5366748166259169,38.0,70.0
20012002,Robert Lang,543,629,1172,62,2,0.46331058020477817,143.0,49.0
20012002,Steve Reinprecht,215,198,413,67,2,0.5205811138014528,63.0,117.0
20012002,Sebastien Bordeleau,86,64,150,20,2,0.5733333333333334,10.0,157.0
20012002,Daymond Langkow,637,742,1379,80,2,0.4619289340101523,145.0,37.0
20012002,Robert Kron,70,104,174,59,2,0.40229885057471265,185.0,162.0
20012002,Eric Belanger,509,373,882,53,2,0.5770975056689343,8.0,53.0
20012002,Erik Rasmussen,94,142,236,69,2,0.3983050847457627,186.0,153.0
20012002,Mike Modano,919,791,1710,78,2,0.5374269005847954,37.0,10.0
20012002,Krys Kolanos,326,377,703,57,2,0.46372688477951635,142.0,95.0
20012002,Artem Chubarov,277,240,517,51,2,0.5357833655705996,42.0,105.0
20012002,Kris Draper,402,354,756,82,2,0.5317460317460317,46.0,76.0
20012002,Robert Reichel,518,527,1045,78,2,0.49569377990430624,91.0,51.0
20012002,Adam Oates,1108,857,1965,80,2,0.5638676844783715,15.0,4.0
20012002,Shayne Corson,68,84,152,19,3,0.4473684210526316,54.0,28.0
20012002,Doug Gilmour,123,110,233,12,3,0.5278969957081545,19.0,13.0
20012002,Keith Primeau,60,43,103,5,3,0.5825242718446602,5.0,33.0
20012002,Trevor Linden,42,51,93,6,3,0.45161290322580644,50.0,44.0
20012002,Travis Green,304,198,502,20,3,0.6055776892430279,3.0,2.0
20012002,Dan Hinote,38,50,88,19,3,0.4318181818181818,58.0,48.0
20012002,Ron Francis,156,130,286,23,3,0.5454545454545454,13.0,9.0
20012002,Juha Ylonen,63,85,148,12,3,0.42567567567567566,60.0,31.0
20012002,Riku Hahl,15,33,48,21,3,0.3125,70.0,60.0
20012002,Pavel Datsyuk,66,95,161,21,3,0.40993788819875776,66.0,29.0
20012002,Igor Korolev,34,44,78,5,3,0.4358974358974359,57.0,51.0
20012002,Pavol Demitra,91,92,183,10,3,0.4972677595628415,31.0,22.0
20012002,Joe Juneau,85,98,183,12,3,0.4644808743169399,46.0,23.0
20012002,Andrew Cassels,39,47,86,6,3,0.45348837209302323,49.0,47.0
20012002,Saku Koivu,62,72,134,12,3,0.4626865671641791,47.0,32.0
20012002,Brad Chartrand,45,31,76,7,3,0.5921052631578947,4.0,42.0
20012002,Joe Nieuwendyk,76,56,132,5,3,0.5757575757575758,7.0,26.0
20012002,Ray Ferraro,36,36,72,10,3,0.5,29.0,49.0
20012002,John Madden,38,52,90,6,3,0.4222222222222222,62.0,48.0
20012002,Steve Yzerman,225,155,380,23,3,0.5921052631578947,4.0,4.0
20012002,Alexei Zhamnov,48,51,99,5,3,0.48484848484848486,37.0,39.0
20012002,Mike Fisher,93,95,188,10,3,0.4946808510638298,33.0,21.0
20012002,Owen Nolan,33,29,62,12,3,0.532258064516129,17.0,52.0
20012002,Yanic Perreault,96,73,169,11,3,0.5680473372781065,9.0,19.0
20012002,Joe Sakic,289,290,579,21,3,0.4991364421416235,30.0,3.0
20012002,Jeff O'Neill,115,122,237,22,3,0.48523206751054854,36.0,15.0
20012002,Adam Oates,77,48,125,5,3,0.616,2.0,25.0
20012002,Marty McInnis,14,17,31,6,3,0.45161290322580644,50.0,61.0
20012002,Henrik Sedin,24,34,58,6,3,0.41379310344827586,65.0,56.0
20012002,Steve Sullivan,15,20,35,5,3,0.42857142857142855,59.0,60.0
20012002,Stephane Yelle,116,145,261,20,3,0.4444444444444444,55.0,14.0
20012002,Jamal Mayers,19,21,40,10,3,0.475,39.0,58.0
20012002,Michael Peca,47,43,90,5,3,0.5222222222222223,21.0,40.0
20012002,Jason Allison,85,92,177,7,3,0.480225988700565,38.0,23.0
20012002,Kevyn Adams,58,59,117,23,3,0.49572649572649574,32.0,34.0
20012002,Marty Murray,21,28,49,5,3,0.42857142857142855,59.0,57.0
20012002,Mats Sundin,85,83,168,8,3,0.5059523809523809,28.0,23.0
20012002,Patrik Elias,26,44,70,6,3,0.37142857142857144,69.0,55.0
20012002,Jason Williams,33,20,53,9,3,0.6226415094339622,1.0,52.0
20012002,Joe Thornton,64,72,136,6,3,0.47058823529411764,42.0,30.0
20012002,Claude Lapointe,32,54,86,7,3,0.37209302325581395,68.0,53.0
20012002,Artem Chubarov,31,38,69,6,3,0.4492753623188406,52.0,54.0
20012002,Kris Draper,179,153,332,23,3,0.5391566265060241,14.0,7.0
20012002,Robert Reichel,95,98,193,18,3,0.49222797927461137,35.0,20.0
20012002,Jozef Stumpel,41,57,98,6,3,0.41836734693877553,64.0,45.0
20012002,Josef Vasicek,127,124,251,23,3,0.5059760956175299,27.0,11.0
20012002,Mike Ricci,132,152,284,12,3,0.4647887323943662,45.0,10.0
20012002,Brendan Morrison,43,41,84,6,3,0.5119047619047619,25.0,43.0
20012002,Jeremy Roenick,38,49,87,5,3,0.4367816091954023,56.0,48.0
20012002,Vincent Damphousse,126,119,245,12,3,0.5142857142857142,23.0,12.0
20012002,Todd Harvey,35,27,62,12,3,0.5645161290322581,10.0,50.0
20012002,Daymond Langkow,57,50,107,5,3,0.5327102803738317,16.0,35.0
20012002,Alyn McCauley,158,193,351,20,3,0.45014245014245013,51.0,8.0
20012002,Shaun Van Allen,17,23,40,7,3,0.425,61.0,59.0
20012002,Chris Drury,182,145,327,21,3,0.5565749235474006,11.0,6.0
20012002,Bryan Smolinski,47,53,100,7,3,0.47,43.0,40.0
20012002,Mike Eastwood,114,99,213,10,3,0.5352112676056338,15.0,16.0
20012002,Michael Nylander,26,25,51,5,3,0.5098039215686274,26.0,55.0
20012002,Igor Larionov,75,92,167,18,3,0.4491017964071856,53.0,27.0
20012002,Eric Belanger,46,42,88,7,3,0.5227272727272727,20.0,41.0
20012002,Tom Fitzgerald,21,20,41,5,3,0.5121951219512195,24.0,57.0
20012002,Alexei Yashin,82,66,148,7,3,0.5540540540540541,12.0,24.0
20012002,Doug Weight,56,62,118,10,3,0.4745762711864407,40.0,36.0
20012002,Sergei Fedorov,216,222,438,23,3,0.4931506849315068,34.0,5.0
20012002,Patrick Marleau,85,78,163,12,3,0.5214723926380368,22.0,23.0
20012002,Michal Handzus,34,38,72,5,3,0.4722222222222222,41.0,51.0
20012002,Bobby Holik,39,63,102,6,3,0.38235294117647056,67.0,47.0
20012002,Rod Brind'Amour,377,272,649,23,3,0.5808936825885979,6.0,1.0
20012002,Brian Rolston,52,46,98,6,3,0.5306122448979592,18.0,38.0
20012002,Radek Bonk,113,157,270,12,3,0.4185185185185185,63.0,17.0
20012002,Daniel Bri√®re,40,40,80,5,3,0.5,29.0,46.0
20012002,Denis Pederson,33,39,72,5,3,0.4583333333333333,48.0,52.0
20012002,Todd White,106,121,227,12,3,0.4669603524229075,44.0,18.0
20012002,Dave Scatchard,54,40,94,7,3,0.574468085106383,8.0,37.0
20022003,Shayne Corson,90,112,202,46,2,0.44554455445544555,158.0,156.0
20022003,Bryan Smolinski,444,514,958,68,2,0.46346555323590816,139.0,71.0
20022003,Keith Primeau,829,784,1613,80,2,0.513949163050217,67.0,10.0
20022003,Steve Martins,264,216,480,42,2,0.55,28.0,105.0
20022003,Trevor Linden,309,259,568,71,2,0.5440140845070423,33.0,96.0
20022003,Mike Sillinger,842,648,1490,75,2,0.5651006711409396,19.0,9.0
20022003,Denis Arkhipov,499,570,1069,79,2,0.4667913938260056,133.0,59.0
20022003,Travis Green,429,373,802,75,2,0.5349127182044888,42.0,74.0
20022003,Dan Hinote,102,116,218,60,2,0.46788990825688076,131.0,151.0
20022003,Tyler Wright,314,446,760,70,2,0.4131578947368421,180.0,95.0
20022003,Wes Walz,759,746,1505,80,2,0.5043189368770764,79.0,19.0
20022003,Ron Francis,462,418,880,82,2,0.525,54.0,67.0
20022003,Henrik Zetterberg,185,216,401,79,2,0.4613466334164589,143.0,122.0
20022003,Milan Kraft,169,223,392,31,2,0.43112244897959184,168.0,128.0
20022003,Scott Gomez,410,454,864,80,2,0.47453703703703703,120.0,79.0
20022003,Mike Comrie,503,566,1069,69,2,0.470533208606174,126.0,57.0
20022003,Pavel Datsyuk,375,403,778,64,2,0.4820051413881748,111.0,84.0
20022003,Shawn McEachern,67,87,154,46,2,0.43506493506493504,165.0,166.0
20022003,Todd Bertuzzi,98,110,208,82,2,0.47115384615384615,125.0,152.0
20022003,Espen Knutsen,128,197,325,31,2,0.39384615384615385,186.0,143.0
20022003,Theo Fleury,186,160,346,54,2,0.5375722543352601,40.0,121.0
20022003,Igor Korolev,159,216,375,48,2,0.424,177.0,131.0
20022003,Mark Recchi,88,80,168,79,2,0.5238095238095238,56.0,157.0
20022003,Pierre Turgeon,156,134,290,65,2,0.5379310344827586,39.0,132.0
20022003,Pavol Demitra,578,675,1253,78,2,0.461292897047087,144.0,43.0
20022003,Joe Juneau,647,588,1235,72,2,0.5238866396761134,55.0,33.0
20022003,Shawn Horcoff,129,172,301,78,2,0.42857142857142855,171.0,142.0
20022003,Cliff Ronning,266,300,566,80,2,0.46996466431095407,127.0,104.0
20022003,Dave Andreychuk,652,465,1117,72,2,0.5837063563115488,5.0,32.0
20022003,Petr Nedved,605,537,1142,78,2,0.5297723292469352,48.0,35.0
20022003,Sean Avery,153,120,273,51,2,0.5604395604395604,24.0,134.0
20022003,Peter Forsberg,333,376,709,75,2,0.4696755994358251,130.0,91.0
20022003,Richard Park,87,91,178,81,2,0.4887640449438202,99.0,158.0
20022003,Daniel Bri√®re,685,629,1314,82,2,0.5213089802130898,60.0,26.0
20022003,Mathias Johansson,275,275,550,58,2,0.5,86.0,100.0
20022003,Saku Koivu,777,789,1566,82,2,0.49616858237547895,90.0,16.0
20022003,Chris Taylor,72,80,152,11,2,0.47368421052631576,121.0,165.0
20022003,Darby Hendrickson,200,213,413,28,2,0.48426150121065376,104.0,116.0
20022003,Matt Cullen,337,357,694,80,2,0.48559077809798273,103.0,90.0
20022003,Vincent Lecavalier,527,673,1200,80,2,0.43916666666666665,161.0,52.0
20022003,Joe Sakic,690,669,1359,58,2,0.5077262693156733,77.0,24.0
20022003,Bobby Holik,809,581,1390,64,2,0.5820143884892086,7.0,11.0
20022003,Robert Lang,491,578,1069,82,2,0.4593077642656688,148.0,61.0
20022003,Byron Ritchie,121,130,251,30,2,0.4820717131474104,110.0,146.0
20022003,Kevyn Adams,540,478,1018,77,2,0.5304518664047151,46.0,48.0
20022003,Pascal Dupuis,76,110,186,80,2,0.40860215053763443,181.0,163.0
20022003,Mark Bell,198,179,377,82,2,0.5251989389920424,53.0,117.0
20022003,Brian Holzinger,86,101,187,14,2,0.45989304812834225,147.0,159.0
20022003,Scott Nichol,208,149,357,68,2,0.5826330532212886,6.0,115.0
20022003,Greg Johnson,392,361,753,38,2,0.5205843293492696,62.0,80.0
20022003,Jeff Halpern,807,685,1492,82,2,0.5408847184986595,35.0,12.0
20022003,Curtis Brown,687,700,1387,74,2,0.4953136265320836,92.0,25.0
20022003,Nik Antropov,249,372,621,72,2,0.40096618357487923,184.0,108.0
20022003,Denis Pederson,221,219,440,43,2,0.5022727272727273,84.0,111.0
20022003,Yanic Perreault,727,429,1156,73,2,0.6288927335640139,1.0,20.0
20022003,Ian Laperriere,156,161,317,73,2,0.4921135646687697,95.0,132.0
20022003,Derek Armstrong,354,354,708,66,2,0.5,86.0,88.0
20022003,Darren McCarty,185,135,320,73,2,0.578125,10.0,122.0
20022003,Jeff O'Neill,533,453,986,82,2,0.5405679513184585,36.0,50.0
20022003,Jim Dowd,445,485,930,78,2,0.478494623655914,115.0,70.0
20022003,Sergei Zholtok,451,547,998,78,2,0.45190380761523047,152.0,69.0
20022003,Marc Chouinard,361,301,662,70,2,0.5453172205438066,31.0,86.0
20022003,Tim Taylor,556,405,961,82,2,0.578563995837669,9.0,46.0
20022003,Kent Manderville,269,281,550,82,2,0.4890909090909091,98.0,103.0
20022003,Tim Connolly,362,483,845,80,2,0.4284023668639053,172.0,85.0
20022003,Vinny Prospal,83,78,161,80,2,0.515527950310559,66.0,162.0
20022003,Steve Dubinsky,152,116,268,28,2,0.5671641791044776,16.0,135.0
20022003,Mark Messier,677,603,1280,78,2,0.52890625,50.0,28.0
20022003,Mike Fisher,518,559,1077,74,2,0.4809656453110492,112.0,53.0
20022003,Jason Spezza,151,179,330,33,2,0.4575757575757576,149.0,136.0
20022003,Marty McInnis,147,198,345,77,2,0.4260869565217391,175.0,138.0
20022003,Andrei Nikolishin,536,411,947,60,2,0.5659978880675819,17.0,49.0
20022003,Shane Doan,248,375,623,82,2,0.39807383627608345,185.0,109.0
20022003,Brad Richards,478,529,1007,80,2,0.4746772591857001,119.0,64.0
20022003,Chris Gratton,779,551,1330,80,2,0.5857142857142857,3.0,15.0
20022003,Jeff Shantz,455,419,874,74,2,0.5205949656750573,61.0,68.0
20022003,Michael Nylander,518,573,1091,80,2,0.4747937671860678,118.0,53.0
20022003,Brad Chartrand,320,303,623,62,2,0.5136436597110754,70.0,94.0
20022003,Stu Barnes,486,513,999,81,2,0.4864864864864865,102.0,62.0
20022003,Shawn Bates,227,171,398,74,2,0.5703517587939698,12.0,110.0
20022003,Joe Nieuwendyk,809,574,1383,80,2,0.5849602313810557,4.0,11.0
20022003,Mario Lemieux,474,555,1029,67,2,0.4606413994169096,146.0,65.0
20022003,Chad Kilger,97,111,208,60,2,0.46634615384615385,135.0,153.0
20022003,Mike Eastwood,467,449,916,70,2,0.509825327510917,74.0,66.0
20022003,Henrik Sedin,480,515,995,78,2,0.4824120603015075,108.0,63.0
20022003,Steve Sullivan,176,206,382,82,2,0.4607329842931937,145.0,124.0
20022003,Mark Smith,360,272,632,75,2,0.569620253164557,14.0,87.0
20022003,Marty Murray,260,212,472,76,2,0.5508474576271186,27.0,106.0
20022003,Kip Miller,85,86,171,72,2,0.49707602339181284,89.0,160.0
20022003,Lasse Pirjeta,141,186,327,51,2,0.43119266055045874,167.0,139.0
20022003,Eric Lindros,412,366,778,81,2,0.5295629820051414,49.0,78.0
20022003,Brian Swanson,212,193,405,44,2,0.5234567901234568,57.0,113.0
20022003,Alexei Zhamnov,690,655,1345,74,2,0.5130111524163569,71.0,24.0
20022003,John Madden,765,737,1502,80,2,0.5093209054593875,75.0,18.0
20022003,Chris Drury,507,435,942,80,2,0.5382165605095541,37.0,56.0
20022003,Jan Hrdina,593,461,1054,61,2,0.562618595825427,20.0,40.0
20022003,Jason Krog,383,251,634,67,2,0.6041009463722398,2.0,82.0
20022003,Todd Marchant,775,561,1336,77,2,0.5800898203592815,8.0,17.0
20022003,Alyn McCauley,270,326,596,80,2,0.45302013422818793,151.0,102.0
20022003,Mats Lindgren,416,347,763,54,2,0.54521625163827,32.0,77.0
20022003,Mark Bell,198,179,377,82,2,0.5251989389920424,53.0,117.0
20022003,Brian Holzinger,86,101,187,14,2,0.45989304812834225,147.0,159.0
20022003,Scott Nichol,208,149,357,68,2,0.5826330532212886,6.0,115.0
20022003,Chris Gratton,779,551,1330,80,2,0.5857142857142857,3.0,15.0
20022003,Olli Jokinen,898,1027,1925,81,2,0.4664935064935065,134.0,5.0
20022003,Radek Bonk,563,655,1218,70,2,0.46223316912972084,142.0,45.0
20022003,Jason Arnott,602,528,1130,72,2,0.5327433628318584,45.0,38.0
20022003,Brian Rolston,546,602,1148,81,2,0.47560975609756095,116.0,47.0
20022003,Jozef Stumpel,875,726,1601,78,2,0.5465334166146159,30.0,6.0
20022003,Josef Vasicek,323,329,652,57,2,0.495398773006135,91.0,93.0
20022003,Viktor Kozlov,173,231,404,74,2,0.4282178217821782,173.0,125.0
20022003,Doug Gilmour,180,182,362,62,2,0.4972375690607735,88.0,123.0
20022003,Mats Sundin,995,779,1774,75,2,0.560879368658399,23.0,1.0
20022003,Alexei Yashin,507,567,1074,81,2,0.4720670391061452,124.0,56.0
20022003,Doug Weight,528,520,1048,70,2,0.5038167938931297,80.0,51.0
20022003,Claude Lemieux,155,175,330,68,2,0.4696969696969697,129.0,133.0
20022003,Mike Ribeiro,180,178,358,52,2,0.5027932960893855,81.0,123.0
20022003,Rob Niedermayer,74,79,153,66,2,0.48366013071895425,106.0,164.0
20022003,Jan Bulis,65,88,153,82,2,0.42483660130718953,176.0,167.0
20022003,Mike Ricci,594,558,1152,75,2,0.515625,65.0,39.0
20022003,Serge Aubin,308,305,613,66,2,0.5024469820554649,83.0,97.0
20022003,Alexander Svitov,169,226,395,63,2,0.4278481012658228,174.0,128.0
20022003,Patrik Elias,187,240,427,81,2,0.4379391100702576,163.0,120.0
20022003,Adam Mair,293,279,572,79,2,0.5122377622377622,72.0,98.0
20022003,Sean Pronger,324,331,655,78,2,0.4946564885496183,94.0,92.0
20022003,Brian Sutherby,126,162,288,72,2,0.4375,164.0,144.0
20022003,Vernon Fiddler,92,79,171,19,2,0.5380116959064327,38.0,155.0
20022003,Brendan Morrison,765,820,1585,82,2,0.48264984227129337,107.0,18.0
20022003,Jeremy Roenick,577,511,1088,79,2,0.5303308823529411,47.0,44.0
20022003,Oleg Kvasha,110,146,256,69,2,0.4296875,169.0,149.0
20022003,Rem Murray,417,421,838,85,2,0.49761336515513127,87.0,76.0
20022003,Jerred Smithson,84,91,175,22,2,0.48,113.0,161.0
20022003,Scott Walker,165,171,336,60,2,0.49107142857142855,96.0,130.0
20022003,Mike York,171,219,390,71,2,0.43846153846153846,162.0,126.0
20022003,Craig Conroy,900,679,1579,79,2,0.5699810006333123,13.0,4.0
20022003,Keith Tkachuk,193,153,346,56,2,0.5578034682080925,26.0,119.0
20022003,Adam Oates,615,449,1064,67,2,0.5780075187969925,11.0,34.0
20022003,Sergei Fedorov,843,737,1580,80,2,0.5335443037974683,44.0,8.0
20022003,Tyler Arnason,252,374,626,82,2,0.402555910543131,183.0,107.0
20022003,Patrick Marleau,663,740,1403,82,2,0.47255880256593014,123.0,31.0
20022003,Erik Rasmussen,124,154,278,57,2,0.4460431654676259,157.0,145.0
20022003,Michael Cammalleri,130,123,253,28,2,0.5138339920948617,68.0,141.0
20022003,Wayne Primeau,670,668,1338,77,2,0.5007473841554559,85.0,30.0
20022003,Steve Rucchin,874,739,1613,82,2,0.541847489150651,34.0,7.0
20022003,Randy Robitaille,273,224,497,51,2,0.5492957746478874,29.0,101.0
20022003,Shaun Van Allen,377,461,838,78,2,0.4498806682577566,153.0,83.0
20022003,Joe Thornton,874,892,1766,77,2,0.49490373725934317,93.0,7.0
20022003,Jason Wiemer,170,177,347,81,2,0.4899135446685879,97.0,127.0
20022003,Vaclav Nedorost,67,84,151,42,2,0.44370860927152317,160.0,166.0
20022003,Cory Stillman,111,155,266,79,2,0.41729323308270677,178.0,148.0
20022003,Stephane Yelle,798,696,1494,82,2,0.5341365461847389,43.0,14.0
20022003,Marc Savard,682,654,1336,67,2,0.5104790419161677,73.0,27.0
20022003,Ryan Johnson,424,445,869,75,2,0.48791714614499426,100.0,75.0
20022003,Vincent Damphousse,672,629,1301,82,2,0.5165257494235204,64.0,29.0
20022003,Kirk Muller,113,88,201,55,2,0.5621890547263682,21.0,147.0
20022003,Tony Hrkac,502,623,1125,80,2,0.44622222222222224,156.0,58.0
20022003,Todd White,705,691,1396,80,2,0.5050143266475645,78.0,22.0
20022003,Dainius Zubrus,284,281,565,63,2,0.5026548672566372,82.0,99.0
20022003,Michal Handzus,706,644,1350,82,2,0.522962962962963,58.0,21.0
20022003,Mark Hartigan,104,116,220,23,2,0.4727272727272727,122.0,150.0
20022003,Jiri Dopita,167,149,316,21,2,0.5284810126582279,51.0,129.0
20022003,Marcus Nilson,219,250,469,82,2,0.4669509594882729,132.0,112.0
20022003,Marty Reasoner,518,450,968,70,2,0.5351239669421488,41.0,53.0
20022003,Igor Larionov,195,259,454,74,2,0.42951541850220265,170.0,118.0
20022003,Stephen Weiss,493,572,1065,77,2,0.4629107981220657,141.0,60.0
20022003,Dan Snyder,148,208,356,36,2,0.4157303370786517,179.0,137.0
20022003,Patrik Stefan,514,611,1125,71,2,0.4568888888888889,150.0,54.0
20022003,Anson Carter,96,126,222,79,2,0.43243243243243246,166.0,154.0
20022003,Shjon Podein,88,102,190,68,2,0.4631578947368421,140.0,157.0
20022003,Owen Nolan,141,141,282,75,2,0.5,86.0,139.0
20022003,Dave Scatchard,604,543,1147,81,2,0.5265911072362686,52.0,36.0
20022003,Chris Herperger,83,104,187,27,2,0.44385026737967914,159.0,162.0
20022003,Claude Lapointe,445,348,793,80,2,0.5611601513240857,22.0,70.0
20022003,David Legwand,510,585,1095,64,2,0.4657534246575342,136.0,55.0
20022003,Rod Brind'Amour,702,540,1242,48,2,0.5652173913043478,18.0,23.0
20022003,Ted Donato,139,151,290,49,2,0.4793103448275862,114.0,140.0
20022003,Niko Kapanen,528,583,1111,82,2,0.4752475247524752,117.0,51.0
20022003,P.J. Stock,83,102,185,71,2,0.4486486486486487,154.0,162.0
20022003,Pierre-Marc Bouchard,193,281,474,50,2,0.40717299578059074,182.0,119.0
20022003,Petr Cajanek,384,409,793,51,2,0.4842370744010088,105.0,81.0
20022003,Andy McDonald,338,266,604,46,2,0.5596026490066225,25.0,89.0
20022003,Andrew Cassels,804,845,1649,79,2,0.48756822316555487,101.0,13.0
20022003,Manny Malhotra,210,237,447,59,2,0.4697986577181208,128.0,114.0
20022003,Steve Reinprecht,431,497,928,77,2,0.4644396551724138,138.0,73.0
20022003,Daymond Langkow,917,1055,1972,82,2,0.46501014198782964,137.0,3.0
20022003,Eric Belanger,592,551,1143,62,2,0.5179352580927384,63.0,41.0
20022003,Mike Modano,929,879,1808,79,2,0.5138274336283186,69.0,2.0
20022003,Artem Chubarov,438,424,862,62,2,0.5081206496519721,76.0,72.0
20022003,Pascal Rheaume,410,440,850,77,2,0.4823529411764706,109.0,79.0
20022003,Kris Draper,603,456,1059,82,2,0.5694050991501416,15.0,37.0
20022003,Robert Reichel,586,537,1123,81,2,0.5218165627782725,59.0,42.0
20022003,Mike Rupp,67,83,150,26,2,0.44666666666666666,155.0,166.0
20022003,Keith Primeau,164,126,290,13,3,0.5655172413793104,17.0,6.0
20022003,Trevor Linden,107,83,190,14,3,0.5631578947368421,18.0,17.0
20022003,Travis Green,36,34,70,4,3,0.5142857142857142,31.0,46.0
20022003,Wes Walz,161,200,361,18,3,0.44598337950138506,59.0,7.0
20022003,Dan Hinote,21,26,47,7,3,0.44680851063829785,58.0,53.0
20022003,Bryan Smolinski,118,140,258,18,3,0.4573643410852713,53.0,15.0
20022003,Scott Gomez,127,161,288,24,3,0.4409722222222222,62.0,13.0
20022003,Mike Comrie,36,34,70,6,3,0.5142857142857142,31.0,46.0
20022003,Pavel Datsyuk,31,33,64,4,3,0.484375,40.0,49.0
20022003,Todd Bertuzzi,13,17,30,14,3,0.43333333333333335,64.0,60.0
20022003,Pavol Demitra,36,49,85,7,3,0.4235294117647059,68.0,46.0
20022003,Dave Andreychuk,112,121,233,11,3,0.48068669527896996,42.0,16.0
20022003,Michael Nylander,32,44,76,6,3,0.42105263157894735,70.0,48.0
20022003,Shawn Horcoff,40,24,64,6,3,0.625,3.0,42.0
20022003,Peter Forsberg,57,47,104,7,3,0.5480769230769231,22.0,32.0
20022003,Stu Barnes,70,76,146,12,3,0.4794520547945205,43.0,27.0
20022003,Jeff Shantz,41,36,77,6,3,0.5324675324675324,25.0,41.0
20022003,Darby Hendrickson,166,177,343,17,3,0.4839650145772595,41.0,5.0
20022003,Jeff Halpern,69,51,120,6,3,0.575,12.0,28.0
20022003,Nik Antropov,17,21,38,3,3,0.4473684210526316,57.0,56.0
20022003,Joe Nieuwendyk,164,125,289,17,3,0.5674740484429066,15.0,6.0
20022003,Vincent Lecavalier,77,129,206,11,3,0.3737864077669903,73.0,25.0
20022003,John Madden,250,283,533,24,3,0.46904315196998125,46.0,1.0
20022003,Steve Yzerman,35,24,59,4,3,0.5932203389830508,9.0,47.0
20022003,Mike Fisher,77,103,180,18,3,0.42777777777777776,66.0,25.0
20022003,Ryan Johnson,27,30,57,6,3,0.47368421052631576,45.0,51.0
20022003,Joe Sakic,106,69,175,7,3,0.6057142857142858,7.0,18.0
20022003,Robert Lang,30,37,67,6,3,0.44776119402985076,56.0,50.0
20022003,Darren McCarty,19,11,30,4,3,0.6333333333333333,1.0,54.0
20022003,Jason Krog,159,127,286,21,3,0.5559440559440559,21.0,8.0
20022003,Todd Marchant,62,55,117,6,3,0.5299145299145299,26.0,30.0
20022003,Henrik Sedin,96,92,188,14,3,0.5106382978723404,33.0,19.0
20022003,Pascal Rheaume,147,174,321,24,3,0.45794392523364486,52.0,11.0
20022003,Brad Richards,68,85,153,11,3,0.4444444444444444,60.0,29.0
20022003,Mats Sundin,120,84,204,7,3,0.5882352941176471,10.0,14.0
20022003,Keith Tkachuk,27,33,60,7,3,0.45,55.0,51.0
20022003,Samuel Pahlsson,134,115,249,21,3,0.5381526104417671,23.0,12.0
20022003,Adam Oates,237,153,390,21,3,0.6076923076923076,6.0,3.0
20022003,Claude Lapointe,87,84,171,13,3,0.5087719298245614,34.0,24.0
20022003,Michal Handzus,120,103,223,13,3,0.5381165919282511,24.0,14.0
20022003,Trent Whitfield,55,34,89,6,3,0.6179775280898876,4.0,34.0
20022003,Mike Modano,134,123,257,12,3,0.5214007782101168,30.0,12.0
20022003,Jim Dowd,93,107,200,15,3,0.465,50.0,21.0
20022003,Sergei Zholtok,106,142,248,18,3,0.4274193548387097,67.0,18.0
20022003,Jozef Stumpel,48,48,96,5,3,0.5,35.0,37.0
20022003,Alexei Yashin,37,42,79,5,3,0.46835443037974683,48.0,45.0
20022003,Doug Weight,45,55,100,7,3,0.45,55.0,39.0
20022003,Brendan Morrison,153,119,272,14,3,0.5625,19.0,9.0
20022003,Jeremy Roenick,94,128,222,13,3,0.42342342342342343,69.0,20.0
20022003,Joe Thornton,54,49,103,5,3,0.5242718446601942,29.0,35.0
20022003,Jason Wiemer,16,17,33,5,3,0.48484848484848486,39.0,57.0
20022003,Marty Reasoner,39,46,85,6,3,0.4588235294117647,51.0,43.0
20022003,Igor Larionov,15,17,32,4,3,0.46875,47.0,58.0
20022003,Manny Malhotra,17,22,39,5,3,0.4358974358974359,63.0,56.0
20022003,Steve Reinprecht,18,18,36,7,3,0.5,35.0,55.0
20022003,Brandon Reid,46,44,90,9,3,0.5111111111111111,32.0,38.0
20022003,Sergei Brylin,26,49,75,19,3,0.3466666666666667,75.0,52.0
20022003,Rob Niedermayer,36,37,73,21,3,0.4931506849315068,36.0,46.0
20022003,Shaun Van Allen,77,92,169,18,3,0.4556213017751479,54.0,25.0
20022003,Steve Rucchin,246,223,469,21,3,0.5245202558635395,28.0,2.0
20022003,Artem Chubarov,127,94,221,14,3,0.5746606334841629,13.0,13.0
20022003,Kris Draper,21,23,44,4,3,0.4772727272727273,44.0,53.0
20022003,Robert Reichel,45,60,105,7,3,0.42857142857142855,65.0,39.0
20022003,Mike Rupp,16,27,43,4,3,0.37209302325581395,74.0,57.0
20022003,Michael Peca,59,44,103,5,3,0.5728155339805825,14.0,31.0
20022003,Tim Taylor,91,54,145,11,3,0.6275862068965518,2.0,22.0
20022003,Sergei Fedorov,38,22,60,4,3,0.6333333333333333,1.0,44.0
20022003,Cory Stillman,38,54,92,6,3,0.41304347826086957,71.0,44.0
20022003,Niko Kapanen,72,103,175,12,3,0.4114285714285714,72.0,26.0
20022003,Pascal Dupuis,14,16,30,16,3,0.4666666666666667,49.0,59.0
20022003,Randy Robitaille,27,19,46,5,3,0.5869565217391305,11.0,51.0
20022003,Brian Rolston,44,35,79,5,3,0.5569620253164557,20.0,40.0
20022003,Radek Bonk,173,178,351,18,3,0.4928774928774929,37.0,4.0
20022003,Jason Arnott,90,85,175,11,3,0.5142857142857142,31.0,23.0
20022003,Patrik Elias,17,18,35,24,3,0.4857142857142857,38.0,56.0
20022003,Alexander Svitov,11,22,33,7,3,0.3333333333333333,76.0,61.0
20022003,Tom Fitzgerald,49,44,93,7,3,0.5268817204301075,27.0,36.0
20022003,Dainius Zubrus,37,25,62,6,3,0.5967741935483871,8.0,45.0
20022003,Todd White,152,116,268,18,3,0.5671641791044776,16.0,10.0
20022003,Shjon Podein,19,24,43,7,3,0.4418604651162791,61.0,54.0
20022003,Dave Scatchard,56,35,91,5,3,0.6153846153846154,5.0,33.0
20032004,Scott Nichol,676,502,1178,75,2,0.5738539898132428,10.0,26.0
20032004,Tommi Santala,129,123,252,33,2,0.5119047619047619,78.0,144.0
20032004,Keith Primeau,538,472,1010,54,2,0.5326732673267327,54.0,50.0
20032004,Daniel Bri√®re,502,564,1066,82,2,0.4709193245778612,131.0,57.0
20032004,Vyacheslav Kozlov,53,111,164,76,2,0.3231707317073171,190.0,169.0
20032004,Trevor Linden,717,568,1285,82,2,0.5579766536964981,21.0,22.0
20032004,Denis Arkhipov,414,512,926,72,2,0.4470842332613391,159.0,78.0
20032004,Blair Betts,134,114,248,20,2,0.5403225806451613,39.0,143.0
20032004,Dan Hinote,73,78,151,59,2,0.48344370860927155,110.0,164.0
20032004,Tyler Wright,138,178,316,68,2,0.43670886075949367,166.0,142.0
20032004,Wes Walz,421,488,909,57,2,0.46314631463146316,138.0,76.0
20032004,Wyatt Smith,110,83,193,18,2,0.5699481865284974,12.0,151.0
20032004,Henrik Zetterberg,286,341,627,61,2,0.45614035087719296,145.0,103.0
20032004,Bryan Smolinski,393,487,880,80,2,0.4465909090909091,160.0,83.0
20032004,Milan Kraft,460,510,970,66,2,0.4742268041237113,122.0,66.0
20032004,Scott Gomez,521,608,1129,80,2,0.46147032772364927,140.0,53.0
20032004,Shawn McEachern,80,101,181,82,2,0.4419889502762431,163.0,161.0
20032004,Pavel Datsyuk,709,605,1314,75,2,0.5395738203957382,40.0,23.0
20032004,Marcus Nilson,145,179,324,83,2,0.44753086419753085,158.0,140.0
20032004,Mark Recchi,156,142,298,82,2,0.5234899328859061,67.0,133.0
20032004,Igor Korolev,218,244,462,62,2,0.47186147186147187,128.0,117.0
20032004,Matt Cullen,372,363,735,56,2,0.5061224489795918,86.0,89.0
20032004,Esa Pirnes,249,300,549,57,2,0.453551912568306,150.0,110.0
20032004,Erik Rasmussen,188,235,423,69,2,0.4444444444444444,162.0,123.0
20032004,Pierre Turgeon,285,293,578,76,2,0.4930795847750865,99.0,104.0
20032004,Joe Juneau,506,488,994,70,2,0.5090543259557344,82.0,56.0
20032004,Pavol Demitra,364,406,770,68,2,0.4727272727272727,125.0,90.0
20032004,Ron Francis,508,396,904,80,2,0.5619469026548672,19.0,55.0
20032004,Shawn Horcoff,698,680,1378,80,2,0.5065312046444121,85.0,24.0
20032004,Patrice Bergeron,345,354,699,71,2,0.49356223175965663,97.0,93.0
20032004,Dave Andreychuk,852,623,1475,82,2,0.5776271186440678,8.0,10.0
20032004,Viktor Kozlov,161,151,312,59,2,0.5160256410256411,73.0,130.0
20032004,Peter Forsberg,232,317,549,39,2,0.4225865209471767,174.0,114.0
20032004,Richard Park,152,227,379,73,2,0.40105540897097625,185.0,137.0
20032004,Matt Stajan,175,275,450,69,2,0.3888888888888889,186.0,125.0
20032004,Kristian Huselius,70,115,185,76,2,0.3783783783783784,188.0,166.0
20032004,Stu Barnes,465,414,879,77,2,0.5290102389078498,60.0,64.0
20032004,Greg Johnson,885,722,1607,82,2,0.5507156191661481,27.0,8.0
20032004,Brad Chartrand,157,133,290,53,2,0.5413793103448276,36.0,132.0
20032004,Joe Nieuwendyk,586,384,970,64,2,0.6041237113402061,4.0,37.0
20032004,Martin Cibak,145,176,321,63,2,0.4517133956386293,152.0,140.0
20032004,Jarome Iginla,166,139,305,81,2,0.5442622950819672,32.0,128.0
20032004,Vincent Lecavalier,463,656,1119,81,2,0.4137622877569258,180.0,65.0
20032004,Adam Hall,196,152,348,79,2,0.5632183908045977,17.0,121.0
20032004,Michael Nylander,71,79,150,18,2,0.47333333333333333,124.0,165.0
20032004,Mike Fisher,150,207,357,24,2,0.42016806722689076,176.0,138.0
20032004,Jason Spezza,456,500,956,78,2,0.4769874476987448,118.0,68.0
20032004,Chris Drury,819,672,1491,76,2,0.5492957746478874,29.0,11.0
20032004,Tuomo Ruutu,147,170,317,82,2,0.4637223974763407,137.0,139.0
20032004,Brett McLean,580,555,1135,76,2,0.5110132158590308,79.0,38.0
20032004,Brad Richards,545,622,1167,82,2,0.4670094258783205,133.0,47.0
20032004,Tim Taylor,397,269,666,82,2,0.5960960960960962,5.0,82.0
20032004,Petr Nedved,557,598,1155,81,2,0.48225108225108226,113.0,44.0
20032004,Rickard Wallin,86,103,189,15,2,0.455026455026455,148.0,158.0
20032004,Mike Sillinger,637,485,1122,76,2,0.5677361853832442,14.0,30.0
20032004,Mike Comrie,237,232,469,49,2,0.5053304904051172,88.0,113.0
20032004,Steve Yzerman,627,507,1134,75,2,0.5529100529100529,25.0,32.0
20032004,Mark Messier,682,559,1241,76,2,0.5495568090249798,28.0,25.0
20032004,Yanic Perreault,561,300,861,69,2,0.6515679442508711,1.0,42.0
20032004,Jason Krog,450,319,769,80,2,0.5851755526657998,6.0,69.0
20032004,Steve Moore,156,231,387,57,2,0.40310077519379844,183.0,133.0
20032004,Byron Ritchie,82,86,168,50,2,0.4880952380952381,105.0,160.0
20032004,Kevyn Adams,375,347,722,73,2,0.5193905817174516,71.0,88.0
20032004,Jason Wiemer,356,442,798,75,2,0.44611528822055135,161.0,92.0
20032004,Ryan Smyth,228,256,484,82,2,0.47107438016528924,130.0,115.0
20032004,Jeff Halpern,819,690,1509,79,2,0.5427435387673957,33.0,11.0
20032004,Nik Antropov,126,183,309,62,2,0.4077669902912621,181.0,147.0
20032004,Mikhail Yakubov,154,183,337,30,2,0.456973293768546,144.0,135.0
20032004,Marc Savard,540,543,1083,45,2,0.4986149584487535,94.0,49.0
20032004,Ian Laperriere,241,205,446,62,2,0.5403587443946188,38.0,111.0
20032004,Dean McAmmond,377,391,768,64,2,0.4908854166666667,103.0,87.0
20032004,Igor Larionov,212,207,419,49,2,0.5059665871121718,87.0,118.0
20032004,Jeff O'Neill,380,280,660,67,2,0.5757575757575758,9.0,86.0
20032004,Derek Armstrong,474,438,912,57,2,0.5197368421052632,70.0,62.0
20032004,Jamal Mayers,331,350,681,80,2,0.48604992657856094,109.0,96.0
20032004,Sergei Fedorov,882,676,1558,80,2,0.5661103979460848,16.0,9.0
20032004,Eric Staal,288,381,669,81,2,0.4304932735426009,171.0,102.0
20032004,Mark Smith,104,103,207,36,2,0.5024154589371981,90.0,153.0
20032004,Saku Koivu,643,551,1194,68,2,0.5385259631490787,43.0,28.0
20032004,Chris Taylor,271,260,531,54,2,0.5103578154425612,80.0,105.0
20032004,Mario Lemieux,85,88,173,10,2,0.4913294797687861,101.0,159.0
20032004,Shawn Bates,337,266,603,69,2,0.5588723051409619,20.0,95.0
20032004,Alexei Zhamnov,417,452,869,43,2,0.4798619102416571,115.0,77.0
20032004,Joe Sakic,897,808,1705,81,2,0.5260997067448681,65.0,6.0
20032004,Bobby Holik,901,763,1664,82,2,0.5414663461538461,35.0,5.0
20032004,Andrei Nikolishin,593,428,1021,49,2,0.5808031341821743,7.0,36.0
20032004,Manny Malhotra,460,393,853,65,2,0.5392731535756154,42.0,66.0
20032004,Michael Peca,889,785,1674,76,2,0.5310633213859021,55.0,7.0
20032004,Brian Holzinger,559,590,1149,74,2,0.4865100087032202,106.0,43.0
20032004,Sergei Brylin,324,371,695,82,2,0.46618705035971225,135.0,99.0
20032004,Mark Bell,187,200,387,82,2,0.48320413436692505,111.0,124.0
20032004,Curtis Brown,659,628,1287,80,2,0.5120435120435121,77.0,27.0
20032004,Eric Lindros,268,224,492,39,2,0.5447154471544715,31.0,106.0
20032004,Steve Sullivan,100,127,227,80,2,0.44052863436123346,164.0,154.0
20032004,Jeff Taffe,95,124,219,59,2,0.4337899543378995,168.0,156.0
20032004,John Madden,734,643,1377,80,2,0.533042846768337,52.0,18.0
20032004,Owen Nolan,129,113,242,65,2,0.5330578512396694,51.0,144.0
20032004,Lasse Pirjeta,327,325,652,70,2,0.5015337423312883,92.0,98.0
20032004,Ryan Johnson,288,249,537,69,2,0.5363128491620112,47.0,102.0
20032004,Rico Fata,568,637,1205,73,2,0.4713692946058091,129.0,39.0
20032004,Jamal Mayers,331,350,681,80,2,0.48604992657856094,109.0,96.0
20032004,Brian Holzinger,559,590,1149,74,2,0.4865100087032202,106.0,43.0
20032004,Sergei Brylin,324,371,695,82,2,0.46618705035971225,135.0,99.0
20032004,Mark Bell,187,200,387,82,2,0.48320413436692505,111.0,124.0
20032004,Marc Chouinard,434,375,809,45,2,0.5364647713226205,46.0,72.0
20032004,Boyd Gordon,141,187,328,41,2,0.4298780487804878,172.0,141.0
20032004,Olli Jokinen,935,1051,1986,82,2,0.47079556898288016,132.0,3.0
20032004,Brian Rolston,611,594,1205,82,2,0.5070539419087137,84.0,34.0
20032004,Radek Bonk,532,652,1184,66,2,0.44932432432432434,155.0,52.0
20032004,Jason Arnott,638,565,1203,73,2,0.5303408146300914,57.0,29.0
20032004,Martin Straka,79,108,187,54,2,0.42245989304812837,175.0,162.0
20032004,Josef Vasicek,128,134,262,82,2,0.48854961832061067,104.0,145.0
20032004,Mats Sundin,904,801,1705,81,2,0.5302052785923753,58.0,4.0
20032004,Cliff Ronning,79,95,174,40,2,0.4540229885057471,149.0,162.0
20032004,Jan Hrdina,425,400,825,68,2,0.5151515151515151,75.0,73.0
20032004,Alexei Yashin,258,345,603,47,2,0.42786069651741293,173.0,107.0
20032004,Doug Weight,562,553,1115,75,2,0.5040358744394619,89.0,41.0
20032004,Mike Ribeiro,409,504,913,81,2,0.447973713033954,157.0,79.0
20032004,Mike Eastwood,721,680,1401,82,2,0.5146324054246967,76.0,20.0
20032004,Steve Begin,212,224,436,52,2,0.48623853211009177,108.0,118.0
20032004,Mike Ricci,612,504,1116,71,2,0.5483870967741935,30.0,33.0
20032004,Matthew Lombardi,475,517,992,79,2,0.4788306451612903,116.0,61.0
20032004,Travis Brigley,86,112,198,36,2,0.43434343434343436,167.0,158.0
20032004,Alexander Svitov,172,200,372,40,2,0.46236559139784944,139.0,126.0
20032004,Jozef Stumpel,545,560,1105,64,2,0.49321266968325794,98.0,47.0
20032004,Jamie Lundmark,153,226,379,56,2,0.40369393139841686,182.0,136.0
20032004,Adam Mair,156,184,340,81,2,0.4588235294117647,143.0,133.0
20032004,Ryan Kesler,78,116,194,28,2,0.4020618556701031,184.0,163.0
20032004,Sergei Zholtok,377,421,798,70,2,0.4724310776942356,127.0,87.0
20032004,Steve Konowalchuk,163,182,345,82,2,0.47246376811594204,126.0,129.0
20032004,Eric Manlow,96,82,178,18,2,0.5393258426966292,41.0,155.0
20032004,Brendan Morrison,758,728,1486,82,2,0.5100942126514132,81.0,15.0
20032004,Jeremy Roenick,436,410,846,62,2,0.5153664302600472,74.0,71.0
20032004,Oleg Kvasha,251,405,656,81,2,0.3826219512195122,187.0,109.0
20032004,Benjamin Simon,67,136,203,52,2,0.33004926108374383,189.0,167.0
20032004,Scott Walker,152,215,367,75,2,0.4141689373297003,179.0,137.0
20032004,Craig Conroy,755,647,1402,63,2,0.5385164051355207,44.0,16.0
20032004,Keith Tkachuk,203,207,410,75,2,0.4951219512195122,96.0,120.0
20032004,Mike York,301,355,656,61,2,0.45884146341463417,142.0,100.0
20032004,Darby Hendrickson,227,198,425,34,2,0.5341176470588235,50.0,116.0
20032004,Samuel Pahlsson,502,406,908,82,2,0.552863436123348,26.0,57.0
20032004,Tyler Arnason,390,514,904,82,2,0.4314159292035398,169.0,84.0
20032004,Patrick Marleau,422,592,1014,80,2,0.4161735700197239,178.0,75.0
20032004,Robert Lang,383,457,840,69,2,0.45595238095238094,146.0,85.0
20032004,Todd Marchant,718,694,1412,77,2,0.5084985835694051,83.0,21.0
20032004,Michael Cammalleri,150,130,280,31,2,0.5357142857142857,49.0,138.0
20032004,Nathan Horton,113,157,270,55,2,0.4185185185185185,177.0,150.0
20032004,Travis Green,470,375,845,64,2,0.5562130177514792,23.0,63.0
20032004,Ryan Malone,63,167,230,81,2,0.27391304347826084,191.0,168.0
20032004,Shaun Van Allen,414,378,792,73,2,0.5227272727272727,68.0,78.0
20032004,Steve Rucchin,775,671,1446,82,2,0.5359612724757953,48.0,13.0
20032004,Joe Thornton,941,730,1671,77,2,0.5631358467983244,18.0,2.0
20032004,Jason Williams,155,160,315,49,2,0.49206349206349204,100.0,134.0
20032004,Serge Aubin,328,340,668,66,2,0.49101796407185627,102.0,97.0
20032004,Steve Martins,105,67,172,25,2,0.6104651162790697,3.0,152.0
20032004,Stephane Yelle,564,432,996,53,2,0.5662650602409639,15.0,40.0
20032004,Claude Lapointe,208,194,402,42,2,0.5174129353233831,72.0,119.0
20032004,Vincent Damphousse,402,362,764,82,2,0.5261780104712042,64.0,81.0
20032004,Randy Robitaille,537,532,1069,69,2,0.5023386342376053,91.0,51.0
20032004,Chris Gratton,748,594,1342,81,2,0.5573770491803278,22.0,17.0
20032004,Tom Fitzgerald,159,141,300,69,2,0.53,59.0,131.0
20032004,Dainius Zubrus,440,476,916,54,2,0.48034934497816595,114.0,70.0
20032004,Wayne Primeau,404,463,867,72,2,0.4659746251441753,136.0,80.0
20032004,Todd White,457,422,879,53,2,0.5199089874857793,69.0,67.0
20032004,Mike Rupp,239,241,480,57,2,0.4979166666666667,95.0,112.0
20032004,Eric Chouinard,129,156,285,48,2,0.45263157894736844,151.0,144.0
20032004,Michal Handzus,727,730,1457,82,2,0.49897048730267674,93.0,19.0
20032004,Craig MacDonald,255,298,553,52,2,0.46112115732368897,141.0,108.0
20032004,Marty Murray,121,108,229,66,2,0.5283842794759825,61.0,149.0
20032004,Marty Reasoner,169,152,321,17,2,0.5264797507788161,63.0,127.0
20032004,Adam Oates,487,364,851,60,2,0.5722679200940071,11.0,59.0
20032004,Stephen Weiss,359,440,799,50,2,0.4493116395494368,156.0,91.0
20032004,Patrik Stefan,659,787,1446,82,2,0.4557399723374827,147.0,27.0
20032004,Trent Whitfield,331,267,598,44,2,0.5535117056856187,24.0,96.0
20032004,Jim Dowd,424,455,879,69,2,0.48236632536973834,112.0,74.0
20032004,Dave Scatchard,554,498,1052,61,2,0.526615969581749,62.0,45.0
20032004,David Legwand,500,609,1109,82,2,0.4508566275924256,153.0,58.0
20032004,Rod Brind'Amour,1110,707,1817,78,2,0.6108970831040176,2.0,1.0
20032004,Niko Kapanen,295,324,619,67,2,0.4765751211631664,120.0,101.0
20032004,Jarret Stoll,551,468,1019,68,2,0.5407262021589794,37.0,46.0
20032004,Petr Cajanek,476,524,1000,70,2,0.476,121.0,60.0
20032004,Andy McDonald,153,129,282,79,2,0.5425531914893617,34.0,136.0
20032004,Andrew Cassels,543,662,1205,58,2,0.45062240663900416,154.0,48.0
20032004,Alyn McCauley,580,636,1216,82,2,0.4769736842105263,119.0,38.0
20032004,Daymond Langkow,635,837,1472,81,2,0.4313858695652174,170.0,31.0
20032004,Eric Belanger,761,657,1418,81,2,0.5366713681241185,45.0,14.0
20032004,Mike Modano,801,722,1523,76,2,0.525935653315824,66.0,12.0
20032004,Artem Chubarov,513,450,963,65,2,0.5327102803738317,53.0,54.0
20032004,Mark Mowers,191,209,400,52,2,0.4775,117.0,122.0
20032004,Krys Kolanos,124,159,283,41,2,0.4381625441696113,165.0,148.0
20032004,Darcy Verot,89,94,183,37,2,0.48633879781420764,107.0,157.0
20032004,Kris Draper,602,456,1058,67,2,0.5689981096408318,13.0,35.0
20032004,Robert Reichel,532,470,1002,69,2,0.530938123752495,56.0,52.0
20032004,Derek Roy,339,376,715,49,2,0.47412587412587415,123.0,94.0
20032004,Patrick Sharp,127,145,272,41,2,0.46691176470588236,134.0,146.0
20032004,Keith Primeau,212,158,370,18,3,0.572972972972973,12.0,4.0
20032004,Trevor Linden,76,58,134,7,3,0.5671641791044776,15.0,24.0
20032004,Henrik Zetterberg,21,19,40,12,3,0.525,25.0,55.0
20032004,Bryan Smolinski,65,38,103,7,3,0.6310679611650486,4.0,30.0
20032004,Scott Gomez,51,52,103,5,3,0.49514563106796117,37.0,36.0
20032004,Pavel Datsyuk,106,93,199,12,3,0.5326633165829145,24.0,20.0
20032004,Darby Hendrickson,50,30,80,6,3,0.625,5.0,37.0
20032004,Pierre Turgeon,25,36,61,5,3,0.4098360655737705,60.0,53.0
20032004,Joe Juneau,36,48,84,11,3,0.42857142857142855,59.0,46.0
20032004,Erik Rasmussen,15,36,51,5,3,0.29411764705882354,73.0,58.0
20032004,Patrice Bergeron,22,23,45,7,3,0.4888888888888889,40.0,54.0
20032004,Dave Andreychuk,228,238,466,23,3,0.4892703862660944,39.0,3.0
20032004,Peter Forsberg,50,64,114,11,3,0.43859649122807015,57.0,37.0
20032004,Stu Barnes,47,39,86,5,3,0.5465116279069767,20.0,39.0
20032004,Greg Johnson,44,51,95,6,3,0.4631578947368421,51.0,42.0
20032004,Ron Francis,80,92,172,12,3,0.46511627906976744,49.0,23.0
20032004,Freddy Modin,15,23,38,23,3,0.39473684210526316,66.0,58.0
20032004,Saku Koivu,121,100,221,11,3,0.5475113122171946,19.0,14.0
20032004,Andreas Johansson,13,28,41,6,3,0.3170731707317073,72.0,59.0
20032004,Joe Nieuwendyk,71,67,138,9,3,0.5144927536231884,28.0,27.0
20032004,Nik Antropov,28,45,73,13,3,0.3835616438356164,67.0,50.0
20032004,Vincent Lecavalier,195,196,391,23,3,0.49872122762148335,34.0,5.0
20032004,John Madden,42,34,76,5,3,0.5526315789473685,18.0,44.0
20032004,Steve Yzerman,74,41,115,11,3,0.6434782608695652,2.0,26.0
20032004,Adam Hall,27,44,71,6,3,0.38028169014084506,68.0,51.0
20032004,Mike Fisher,50,54,104,7,3,0.4807692307692308,43.0,37.0
20032004,Yanic Perreault,86,43,129,9,3,0.6666666666666666,1.0,22.0
20032004,Steve Sullivan,11,22,33,6,3,0.3333333333333333,71.0,60.0
20032004,Joe Sakic,110,85,195,11,3,0.5641025641025641,16.0,17.0
20032004,Darren McCarty,34,23,57,12,3,0.5964912280701754,8.0,48.0
20032004,Henrik Sedin,49,51,100,7,3,0.49,38.0,38.0
20032004,Andrei Nikolishin,144,99,243,11,3,0.5925925925925926,9.0,10.0
20032004,Jan Hrdina,26,22,48,5,3,0.5416666666666666,23.0,52.0
20032004,Brad Richards,175,204,379,23,3,0.46174142480211083,52.0,7.0
20032004,Alexei Yashin,21,31,52,5,3,0.40384615384615385,63.0,55.0
20032004,Doug Weight,31,35,66,5,3,0.4696969696969697,48.0,49.0
20032004,Travis Green,67,50,117,7,3,0.5726495726495726,13.0,29.0
20032004,Joe Thornton,59,74,133,7,3,0.44360902255639095,56.0,32.0
20032004,Wayne Primeau,45,66,111,17,3,0.40540540540540543,61.0,41.0
20032004,Todd White,56,57,113,7,3,0.49557522123893805,36.0,34.0
20032004,Dave Scatchard,55,32,87,5,3,0.632183908045977,3.0,35.0
20032004,David Legwand,43,48,91,6,3,0.4725274725274725,47.0,43.0
20032004,Chuck Kobasew,34,41,75,26,3,0.4533333333333333,55.0,48.0
20032004,Eric Perrin,15,22,37,12,3,0.40540540540540543,61.0,58.0
20032004,Brian Rolston,46,45,91,7,3,0.5054945054945055,32.0,40.0
20032004,Jason Arnott,42,46,88,5,3,0.4772727272727273,44.0,44.0
20032004,Radek Bonk,51,75,126,7,3,0.40476190476190477,62.0,36.0
20032004,Brendan Morrison,75,63,138,7,3,0.5434782608695652,21.0,25.0
20032004,Jeremy Roenick,57,60,117,18,3,0.48717948717948717,41.0,33.0
20032004,Stephane Yelle,278,235,513,23,3,0.5419103313840156,22.0,2.0
20032004,Vincent Damphousse,19,32,51,17,3,0.37254901960784315,69.0,56.0
20032004,Alyn McCauley,35,35,70,11,3,0.5,33.0,47.0
20032004,Chris Gratton,44,46,90,11,3,0.4888888888888889,40.0,42.0
20032004,Marcel Goc,19,14,33,5,3,0.5757575757575758,11.0,56.0
20032004,Tim Taylor,131,105,236,23,3,0.5550847457627118,17.0,13.0
20032004,Matthew Lombardi,75,89,164,13,3,0.4573170731707317,54.0,25.0
20032004,Jim Dowd,68,69,137,11,3,0.49635036496350365,35.0,28.0
20032004,Robert Lang,103,69,172,12,3,0.5988372093023255,7.0,21.0
20032004,Mike Sillinger,57,53,110,5,3,0.5181818181818182,27.0,33.0
20032004,Mike Modano,61,58,119,5,3,0.5126050420168067,30.0,31.0
20032004,Marcus Nilson,187,281,468,26,3,0.3995726495726496,65.0,6.0
20032004,Mike Ribeiro,37,41,78,11,3,0.47435897435897434,46.0,45.0
20032004,Patrick Marleau,145,187,332,17,3,0.4367469879518072,58.0,9.0
20032004,Sergei Zholtok,21,39,60,6,3,0.35,70.0,55.0
20032004,Michael Nylander,18,27,45,6,3,0.4,64.0,57.0
20032004,Petr Cajanek,49,36,85,5,3,0.5764705882352941,10.0,38.0
20032004,Michael Peca,68,68,136,5,3,0.5,33.0,28.0
20032004,Mats Sundin,108,72,180,9,3,0.6,6.0,19.0
20032004,Mike Ricci,142,138,280,17,3,0.5071428571428571,31.0,11.0
20032004,Alexei Zhamnov,116,125,241,18,3,0.48132780082987553,42.0,16.0
20032004,Craig Conroy,355,337,692,26,3,0.5130057803468208,29.0,1.0
20032004,Michal Handzus,157,172,329,18,3,0.47720364741641336,45.0,8.0
20032004,Artem Chubarov,67,79,146,7,3,0.4589041095890411,53.0,29.0
20032004,Kris Draper,132,100,232,12,3,0.5689655172413793,14.0,12.0
20032004,Curtis Brown,120,138,258,17,3,0.46511627906976744,49.0,15.0
20032004,Patrick Sharp,19,22,41,12,3,0.4634146341463415,50.0,56.0
20032004,Robert Reichel,109,99,208,12,3,0.5240384615384616,26.0,18.0
20052006,Keith Primeau,95,79,174,9,2,0.5459770114942529,23.0,153.0
20052006,Daniel Bri√®re,262,255,517,48,2,0.5067698259187621,78.0,106.0
20052006,Vyacheslav Kozlov,126,191,317,82,2,0.39747634069400634,177.0,144.0
20052006,Trevor Linden,331,337,668,82,2,0.49550898203592814,101.0,89.0
20052006,Pierre Turgeon,282,298,580,62,2,0.4862068965517241,117.0,100.0
20052006,Jason Allison,439,437,876,66,2,0.5011415525114156,91.0,65.0
20052006,Jason Blake,65,87,152,76,2,0.4276315789473684,168.0,165.0
20052006,Chris Clark,103,106,209,78,2,0.49282296650717705,103.0,150.0
20052006,Jozef Stumpel,450,466,916,74,2,0.4912663755458515,108.0,58.0
20052006,Brad Boyes,142,123,265,82,2,0.5358490566037736,33.0,136.0
20052006,Mike York,594,695,1289,75,2,0.460822342901474,148.0,29.0
20052006,Dan Hinote,141,194,335,73,2,0.4208955223880597,173.0,137.0
20052006,Mike Richards,418,496,914,79,2,0.4573304157549234,154.0,69.0
20052006,Wes Walz,525,594,1119,82,2,0.4691689008042895,137.0,47.0
20052006,Paul Gaustad,433,396,829,78,2,0.5223160434258143,53.0,68.0
20052006,Darren McCarty,117,117,234,67,2,0.5,94.0,147.0
20052006,Todd Bertuzzi,159,204,363,82,2,0.4380165289256198,166.0,134.0
20052006,Henrik Zetterberg,293,290,583,77,2,0.5025728987993139,89.0,97.0
20052006,Bryan Smolinski,517,522,1039,81,2,0.49759384023099135,97.0,48.0
20052006,R.J. Umberger,82,81,163,73,2,0.5030674846625767,84.0,159.0
20052006,Serge Payer,258,285,543,71,2,0.47513812154696133,132.0,108.0
20052006,Erik Rasmussen,86,144,230,67,2,0.3739130434782609,183.0,158.0
20052006,Shawn Horcoff,749,672,1421,79,2,0.5270935960591133,44.0,15.0
20052006,Martin Straka,94,143,237,82,2,0.39662447257383965,179.0,154.0
20052006,Scott Gomez,754,680,1434,82,2,0.5258019525801952,48.0,14.0
20052006,Pavel Datsyuk,562,497,1059,75,2,0.5306893295561851,39.0,35.0
20052006,Erik Christensen,202,179,381,33,2,0.5301837270341208,40.0,120.0
20052006,Mark Recchi,189,204,393,83,2,0.48091603053435117,125.0,123.0
20052006,Patrice Bergeron,791,656,1447,81,2,0.5466482377332412,22.0,9.0
20052006,Dave Andreychuk,258,216,474,42,2,0.5443037974683544,25.0,108.0
20052006,Kyle Wellwood,334,259,593,81,2,0.5632377740303541,11.0,87.0
20052006,Matt Stajan,166,207,373,80,2,0.4450402144772118,162.0,131.0
20052006,Jan Hrdina,564,522,1086,75,2,0.5193370165745856,59.0,34.0
20052006,Vinny Prospal,121,146,267,81,2,0.45318352059925093,158.0,146.0
20052006,Steve Yzerman,239,175,414,61,2,0.5772946859903382,6.0,113.0
20052006,Petr Nedved,366,349,715,53,2,0.5118881118881119,71.0,80.0
20052006,Antoine Vermette,311,226,537,82,2,0.5791433891992551,4.0,94.0
20052006,Jeff Carter,329,354,683,81,2,0.4816983894582723,122.0,90.0
20052006,Tomas Plekanec,356,352,708,67,2,0.5028248587570622,87.0,83.0
20052006,Kevyn Adams,311,322,633,82,2,0.4913112164296998,107.0,94.0
20052006,Sergei Brylin,393,414,807,82,2,0.48698884758364314,115.0,73.0
20052006,Peter Forsberg,476,465,941,60,2,0.5058448459086079,81.0,52.0
20052006,Mark Bell,501,533,1034,82,2,0.48452611218568664,119.0,49.0
20052006,Marcus Nilson,178,214,392,70,2,0.45408163265306123,157.0,129.0
20052006,Saku Koivu,759,653,1412,72,2,0.5375354107648725,30.0,13.0
20052006,Mike Ricci,564,582,1146,78,2,0.49214659685863876,104.0,34.0
20052006,Sidney Crosby,534,640,1174,81,2,0.454855195911414,156.0,42.0
20052006,Vincent Lecavalier,700,666,1366,80,2,0.5124450951683748,69.0,21.0
20052006,Jarome Iginla,293,248,541,82,2,0.5415896487985212,28.0,97.0
20052006,Jochen Hecht,62,94,156,64,2,0.3974358974358974,178.0,167.0
20052006,Adam Hall,230,240,470,75,2,0.48936170212765956,111.0,115.0
20052006,Mike Fisher,444,439,883,68,2,0.5028312570781427,86.0,61.0
20052006,Chris Drury,911,730,1641,81,2,0.5551492992078001,16.0,3.0
20052006,Jason Spezza,642,578,1220,68,2,0.5262295081967213,46.0,25.0
20052006,Chris Gratton,492,468,960,76,2,0.5125,68.0,51.0
20052006,Mike Comrie,412,369,781,80,2,0.5275288092189501,43.0,71.0
20052006,Johan Franzen,71,100,171,80,2,0.4152046783625731,175.0,163.0
20052006,Geoff Sanderson,183,177,360,77,2,0.5083333333333333,74.0,126.0
20052006,Boyd Gordon,100,116,216,25,2,0.46296296296296297,147.0,151.0
20052006,Olli Jokinen,448,507,955,82,2,0.46910994764397906,138.0,59.0
20052006,Mike Rupp,127,138,265,40,2,0.47924528301886793,127.0,143.0
20052006,Ryan Smyth,76,83,159,75,2,0.4779874213836478,129.0,161.0
20052006,Mike Sillinger,748,591,1339,79,2,0.5586258401792382,14.0,16.0
20052006,Sean Avery,100,126,226,75,2,0.4424778761061947,164.0,151.0
20052006,Jeff Halpern,803,651,1454,70,2,0.5522696011004127,19.0,7.0
20052006,Jeremy Roenick,265,271,536,58,2,0.4944029850746269,102.0,103.0
20052006,Nik Antropov,59,113,172,57,2,0.3430232558139535,185.0,169.0
20052006,Tyler Arnason,309,355,664,79,2,0.46536144578313254,143.0,95.0
20052006,Derek Armstrong,277,269,546,62,2,0.5073260073260073,75.0,101.0
20052006,Randy Robitaille,196,185,381,67,2,0.5144356955380578,64.0,122.0
20052006,Eric Staal,557,752,1309,82,2,0.4255156608097785,171.0,39.0
20052006,Mark Smith,267,247,514,80,2,0.519455252918288,58.0,102.0
20052006,Tim Taylor,528,485,1013,82,2,0.5212240868706811,55.0,46.0
20052006,Jason Ward,73,80,153,81,2,0.477124183006536,130.0,162.0
20052006,Stu Barnes,325,324,649,78,2,0.5007704160246533,93.0,91.0
20052006,Jeff Giuliano,116,136,252,48,2,0.4603174603174603,149.0,148.0
20052006,Greg Johnson,558,458,1016,68,2,0.5492125984251969,20.0,38.0
20052006,Tim Connolly,359,485,844,63,2,0.4253554502369668,172.0,82.0
20052006,Radek Bonk,456,507,963,61,2,0.4735202492211838,135.0,56.0
20052006,John Madden,831,782,1613,82,2,0.5151890886546807,62.0,6.0
20052006,Manny Malhotra,466,361,827,58,2,0.5634824667472793,10.0,53.0
20052006,Marc Savard,789,740,1529,82,2,0.5160235448005233,61.0,10.0
20052006,Ryan Getzlaf,235,299,534,57,2,0.4400749063670412,165.0,114.0
20052006,Henrik Sedin,628,610,1238,82,2,0.5072697899838449,77.0,26.0
20052006,Dean McAmmond,137,152,289,78,2,0.4740484429065744,133.0,139.0
20052006,Marcel Goc,387,421,808,81,2,0.47896039603960394,128.0,75.0
20052006,Michael Nylander,532,611,1143,81,2,0.4654418197725284,142.0,43.0
20052006,Oleg Kvasha,133,121,254,64,2,0.5236220472440944,51.0,140.0
20052006,Jim Dowd,436,408,844,78,2,0.5165876777251185,60.0,66.0
20052006,Marc Chouinard,574,515,1089,74,2,0.527089072543618,45.0,32.0
20052006,Michael Peca,575,473,1048,71,2,0.5486641221374046,21.0,31.0
20052006,Freddy Modin,88,83,171,77,2,0.5146198830409356,63.0,156.0
20052006,Curtis Brown,446,435,881,71,2,0.5062429057888763,80.0,60.0
20052006,Ian Laperriere,442,521,963,82,2,0.45898234683281414,151.0,62.0
20052006,Joe Nieuwendyk,727,497,1224,65,2,0.5939542483660131,2.0,19.0
20052006,Martin Cibak,57,118,175,65,2,0.32571428571428573,186.0,170.0
20052006,Mario Lemieux,253,204,457,26,2,0.5536105032822757,18.0,111.0
20052006,Shawn Bates,545,518,1063,66,2,0.5126999059266227,66.0,40.0
20052006,Mikhail Yakubov,61,98,159,23,2,0.3836477987421384,181.0,168.0
20052006,Ryan Johnson,318,251,569,65,2,0.5588752196836555,13.0,93.0
20052006,Marc Savard,789,740,1529,82,2,0.5160235448005233,61.0,10.0
20052006,Joe Sakic,876,793,1669,82,2,0.5248651887357699,49.0,4.0
20052006,Mark Cullen,137,144,281,29,2,0.4875444839857651,114.0,139.0
20052006,Mike Johnson,104,130,234,80,2,0.4444444444444444,163.0,149.0
20052006,Brett McLean,390,380,770,82,2,0.5064935064935064,79.0,74.0
20052006,Martin Lapointe,200,154,354,82,2,0.5649717514124294,8.0,121.0
20052006,Jamal Mayers,176,187,363,67,2,0.48484848484848486,118.0,130.0
20052006,Michael Nylander,532,611,1143,81,2,0.4654418197725284,142.0,43.0
20052006,Oleg Kvasha,133,121,254,64,2,0.5236220472440944,51.0,140.0
20052006,Boyd Gordon,100,116,216,25,2,0.46296296296296297,147.0,151.0
20052006,Olli Jokinen,448,507,955,82,2,0.46910994764397906,138.0,59.0
20052006,Mike Rupp,127,138,265,40,2,0.47924528301886793,127.0,143.0
20052006,Steve Reinprecht,417,449,866,80,2,0.4815242494226328,123.0,70.0
20052006,Doug Weight,436,458,894,70,2,0.48769574944071586,113.0,66.0
20052006,Jason Arnott,668,638,1306,81,2,0.5114854517611026,72.0,23.0
20052006,Clarke Wilm,363,331,694,60,2,0.5230547550432276,52.0,81.0
20052006,Wayne Primeau,454,489,943,71,2,0.4814422057264051,124.0,57.0
20052006,Jay McClement,324,367,691,67,2,0.46888567293777134,139.0,92.0
20052006,Mats Sundin,841,716,1557,70,2,0.5401412973667309,29.0,5.0
20052006,Alexei Yashin,560,556,1116,82,2,0.5017921146953405,90.0,36.0
20052006,Dan Fritsche,132,138,270,59,2,0.4888888888888889,112.0,141.0
20052006,Andy Hilbert,64,103,167,47,2,0.38323353293413176,182.0,166.0
20052006,Mike Ribeiro,377,466,843,79,2,0.4472123368920522,160.0,78.0
20052006,Craig Conroy,732,697,1429,78,2,0.5122463261021694,70.0,18.0
20052006,Steve Ott,263,272,535,82,2,0.491588785046729,105.0,105.0
20052006,Steve Begin,287,286,573,76,2,0.5008726003490401,92.0,99.0
20052006,Matthew Lombardi,264,235,499,55,2,0.5290581162324649,41.0,104.0
20052006,Brian Sutherby,440,464,904,76,2,0.48672566371681414,116.0,64.0
20052006,Ryan Kesler,460,524,984,82,2,0.46747967479674796,141.0,55.0
20052006,Vernon Fiddler,244,220,464,40,2,0.5258620689655172,47.0,112.0
20052006,Matt Cullen,304,279,583,78,2,0.5214408233276158,54.0,96.0
20052006,Brad Richardson,125,180,305,41,2,0.4098360655737705,176.0,145.0
20052006,Brendan Morrison,670,658,1328,82,2,0.5045180722891566,82.0,22.0
20052006,Mark Hartigan,87,107,194,33,2,0.4484536082474227,159.0,157.0
20052006,Trevor Letowski,130,154,284,81,2,0.45774647887323944,153.0,142.0
20052006,Dany Heatley,89,77,166,82,2,0.536144578313253,32.0,155.0
20052006,Keith Tkachuk,126,124,250,41,2,0.504,83.0,144.0
20052006,Samuel Pahlsson,801,716,1517,82,2,0.5280158206987475,42.0,8.0
20052006,Dave Scatchard,465,401,866,63,2,0.5369515011547344,31.0,54.0
20052006,Patrick Marleau,569,647,1216,82,2,0.46792763157894735,140.0,33.0
20052006,Eric Lindros,257,223,480,33,2,0.5354166666666667,34.0,109.0
20052006,Michael Cammalleri,309,269,578,80,2,0.5346020761245674,35.0,95.0
20052006,David Vyborny,88,204,292,80,2,0.3013698630136986,188.0,156.0
20052006,Trent Whitfield,180,150,330,30,2,0.5454545454545454,24.0,128.0
20052006,Sergei Fedorov,650,599,1249,67,2,0.5204163330664532,56.0,24.0
20052006,Rob Niedermayer,204,243,447,76,2,0.4563758389261745,155.0,118.0
20052006,Travis Green,531,445,976,82,2,0.5440573770491803,26.0,44.0
20052006,Ryan Malone,288,440,728,77,2,0.3956043956043956,180.0,98.0
20052006,Max Talbot,203,270,473,48,2,0.42917547568710357,167.0,119.0
20052006,Bobby Holik,771,614,1385,64,2,0.5566787003610109,15.0,11.0
20052006,Zach Parise,69,93,162,81,2,0.42592592592592593,170.0,164.0
20052006,Teemu Selanne,87,122,209,80,2,0.41626794258373206,174.0,157.0
20052006,Brooks Laich,331,335,666,73,2,0.496996996996997,98.0,89.0
20052006,Miroslav Satan,182,160,342,82,2,0.5321637426900585,37.0,127.0
20052006,Jim Slater,162,125,287,71,2,0.5644599303135889,9.0,133.0
20052006,Robert Lang,433,428,861,72,2,0.502903600464576,85.0,68.0
20052006,Serge Aubin,215,253,468,74,2,0.4594017094017094,150.0,117.0
20052006,Stephane Yelle,594,478,1072,74,2,0.5541044776119403,17.0,29.0
20052006,Jerred Smithson,333,280,613,66,2,0.5432300163132137,27.0,88.0
20052006,Boyd Devereaux,103,178,281,78,2,0.3665480427046263,184.0,150.0
20052006,Dainius Zubrus,562,556,1118,71,2,0.5026833631484794,88.0,35.0
20052006,Petr Prucha,78,72,150,68,2,0.52,57.0,160.0
20052006,Michal Handzus,608,535,1143,73,2,0.531933508311461,38.0,28.0
20052006,Mike Knuble,52,109,161,82,2,0.32298136645962733,187.0,171.0
20052006,Todd White,435,451,886,61,2,0.4909706546275395,109.0,67.0
20052006,Patrick Sharp,339,363,702,72,2,0.4829059829059829,121.0,86.0
20052006,Blair Betts,436,381,817,66,2,0.5336597307221542,36.0,66.0
20052006,Todd Marchant,529,503,1032,79,2,0.5125968992248062,67.0,45.0
20052006,Mikko Koivu,343,381,724,64,2,0.47375690607734805,134.0,84.0
20052006,Marty Reasoner,381,370,751,77,2,0.507323568575233,76.0,76.0
20052006,Shane Endicott,218,204,422,41,2,0.5165876777251185,60.0,116.0
20052006,Alexei Zhamnov,138,144,282,24,2,0.48936170212765956,111.0,138.0
20052006,Daymond Langkow,535,595,1130,82,2,0.47345132743362833,136.0,41.0
20052006,Stephen Weiss,255,259,514,41,2,0.4961089494163424,100.0,110.0
20052006,Brian Rolston,187,216,403,82,2,0.4640198511166253,144.0,124.0
20052006,Yanic Perreault,559,340,899,69,2,0.6218020022246941,1.0,37.0
20052006,Patrik Stefan,380,440,820,64,2,0.4634146341463415,145.0,77.0
20052006,Andrew Cassels,157,158,315,31,2,0.4984126984126984,96.0,135.0
20052006,Byron Ritchie,164,149,313,45,2,0.5239616613418531,50.0,132.0
20052006,Wyatt Smith,186,198,384,42,2,0.484375,120.0,125.0
20052006,David Legwand,259,321,580,44,2,0.44655172413793104,161.0,107.0
20052006,Rod Brind'Amour,1268,877,2145,78,2,0.5911421911421911,3.0,1.0
20052006,Niko Kapanen,398,400,798,81,2,0.49874686716791977,95.0,72.0
20052006,Joe Thornton,922,876,1798,81,2,0.5127919911012235,65.0,2.0
20052006,Chris Kelly,370,438,808,82,2,0.45792079207920794,152.0,79.0
20052006,Rico Fata,97,130,227,47,2,0.42731277533039647,169.0,152.0
20052006,Jarret Stoll,765,583,1348,82,2,0.5675074183976261,7.0,12.0
20052006,Petr Cajanek,441,447,888,71,2,0.4966216216216216,99.0,63.0
20052006,Andy McDonald,616,479,1095,82,2,0.5625570776255707,12.0,27.0
20052006,Dominic Moore,377,437,814,82,2,0.4631449631449631,146.0,78.0
20052006,Steve Rucchin,495,543,1038,72,2,0.476878612716763,131.0,50.0
20052006,Alyn McCauley,340,352,692,76,2,0.4913294797687861,106.0,85.0
20052006,Eric Belanger,578,601,1179,65,2,0.4902459711620017,110.0,30.0
20052006,Mike Modano,726,695,1421,78,2,0.5109078114004222,73.0,20.0
20052006,Kris Draper,743,544,1287,80,2,0.5773115773115773,5.0,17.0
20052006,Derek Roy,387,420,807,70,2,0.4795539033457249,126.0,75.0
20052006,Daniel Bri√®re,80,89,169,18,3,0.47337278106508873,45.0,17.0
20052006,Dan Hinote,27,32,59,9,3,0.4576271186440678,53.0,46.0
20052006,Mike Richards,33,25,58,6,3,0.5689655172413793,14.0,44.0
20052006,Henrik Zetterberg,38,45,83,6,3,0.4578313253012048,52.0,41.0
20052006,Bryan Smolinski,64,62,126,10,3,0.5079365079365079,35.0,25.0
20052006,Scott Gomez,58,86,144,9,3,0.4027777777777778,67.0,27.0
20052006,Pavel Datsyuk,54,42,96,5,3,0.5625,15.0,29.0
20052006,Paul Gaustad,104,102,206,18,3,0.5048543689320388,36.0,12.0
20052006,Erik Rasmussen,13,24,37,9,3,0.35135135135135137,73.0,54.0
20052006,Shawn Horcoff,279,239,518,24,3,0.5386100386100386,27.0,2.0
20052006,Stu Barnes,19,17,36,5,3,0.5277777777777778,32.0,51.0
20052006,Greg Johnson,44,28,72,5,3,0.6111111111111112,4.0,36.0
20052006,Ryan Smyth,43,49,92,24,3,0.4673913043478261,49.0,37.0
20052006,Saku Koivu,25,21,46,3,3,0.5434782608695652,22.0,48.0
20052006,Tim Connolly,35,52,87,8,3,0.40229885057471265,68.0,43.0
20052006,Radek Bonk,53,46,99,6,3,0.5353535353535354,29.0,30.0
20052006,Mike Sillinger,67,29,96,5,3,0.6979166666666666,1.0,22.0
20052006,Jarome Iginla,26,30,56,7,3,0.4642857142857143,50.0,47.0
20052006,Vincent Lecavalier,42,51,93,5,3,0.45161290322580644,54.0,38.0
20052006,Steve Yzerman,27,23,50,4,3,0.54,26.0,46.0
20052006,John Madden,95,98,193,9,3,0.49222797927461137,40.0,15.0
20052006,Jochen Hecht,26,29,55,15,3,0.4727272727272727,46.0,47.0
20052006,Jason Spezza,108,85,193,10,3,0.5595854922279793,16.0,10.0
20052006,Mike Fisher,76,85,161,10,3,0.4720496894409938,47.0,19.0
20052006,Chris Drury,213,202,415,18,3,0.5132530120481927,33.0,4.0
20052006,Antoine Vermette,65,45,110,10,3,0.5909090909090909,6.0,24.0
20052006,Joe Sakic,107,94,201,9,3,0.5323383084577115,30.0,11.0
20052006,Jeff Carter,27,29,56,6,3,0.48214285714285715,43.0,46.0
20052006,Ryan Getzlaf,64,99,163,16,3,0.39263803680981596,70.0,25.0
20052006,Brett McLean,49,35,84,8,3,0.5833333333333334,9.0,34.0
20052006,Marcel Goc,50,94,144,11,3,0.3472222222222222,74.0,33.0
20052006,Tomas Plekanec,52,37,89,6,3,0.5842696629213483,8.0,31.0
20052006,Rem Murray,59,77,136,24,3,0.4338235294117647,58.0,26.0
20052006,Jason Arnott,69,37,106,5,3,0.6509433962264151,2.0,20.0
20052006,Joe Thornton,125,174,299,11,3,0.4180602006688963,63.0,8.0
20052006,Matt Cullen,24,33,57,25,3,0.42105263157894735,61.0,49.0
20052006,Rob Niedermayer,17,20,37,16,3,0.4594594594594595,51.0,52.0
20052006,Robert Lang,33,27,60,6,3,0.55,19.0,44.0
20052006,Jim Dowd,54,53,107,9,3,0.5046728971962616,37.0,29.0
20052006,Rod Brind'Amour,377,281,658,25,3,0.5729483282674772,12.0,1.0
20052006,Niko Kapanen,28,31,59,5,3,0.4745762711864407,44.0,45.0
20052006,Jarret Stoll,227,171,398,24,3,0.5703517587939698,13.0,3.0
20052006,Chris Kelly,26,27,53,10,3,0.49056603773584906,41.0,47.0
20052006,Kevyn Adams,97,69,166,25,3,0.5843373493975904,7.0,14.0
20052006,Eric Staal,124,171,295,25,3,0.42033898305084744,62.0,9.0
20052006,Mark Smith,38,28,66,11,3,0.5757575757575758,11.0,41.0
20052006,Matthew Lombardi,28,37,65,7,3,0.4307692307692308,59.0,45.0
20052006,Teemu Selanne,51,42,93,16,3,0.5483870967741935,20.0,32.0
20052006,Michal Handzus,42,35,77,6,3,0.5454545454545454,21.0,38.0
20052006,Steve Rucchin,15,19,34,4,3,0.4411764705882353,56.0,53.0
20052006,Alyn McCauley,23,39,62,6,3,0.3709677419354839,72.0,50.0
20052006,Daniel Cleary,26,18,44,6,3,0.5909090909090909,6.0,47.0
20052006,Brad Richards,55,62,117,5,3,0.4700854700854701,48.0,28.0
20052006,Mike Ribeiro,42,36,78,6,3,0.5384615384615384,28.0,38.0
20052006,Patrick Marleau,66,99,165,11,3,0.4,69.0,23.0
20052006,Stephane Yelle,79,53,132,7,3,0.5984848484848485,5.0,18.0
20052006,Blair Betts,39,28,67,4,3,0.582089552238806,10.0,40.0
20052006,Andy McDonald,94,75,169,16,3,0.5562130177514792,17.0,16.0
20052006,Michael Nylander,28,40,68,4,3,0.4117647058823529,65.0,45.0
20052006,Sergei Brylin,64,54,118,9,3,0.5423728813559322,24.0,25.0
20052006,Peter Forsberg,42,59,101,6,3,0.4158415841584158,64.0,38.0
20052006,Samuel Pahlsson,156,157,313,16,3,0.4984025559105431,39.0,6.0
20052006,Jiri Novotny,15,25,40,4,3,0.375,71.0,53.0
20052006,David Legwand,37,37,74,5,3,0.5,38.0,42.0
20052006,Byron Ritchie,28,25,53,7,3,0.5283018867924528,31.0,45.0
20052006,Kris Draper,38,32,70,6,3,0.5428571428571428,23.0,41.0
20052006,Derek Roy,68,93,161,18,3,0.422360248447205,60.0,21.0
20052006,Todd Marchant,100,130,230,16,3,0.43478260869565216,57.0,13.0
20052006,Michael Peca,186,180,366,24,3,0.5081967213114754,34.0,5.0
20052006,Tim Taylor,28,17,45,5,3,0.6222222222222222,3.0,45.0
20052006,Brad Richardson,40,58,98,9,3,0.40816326530612246,66.0,39.0
20052006,Petr Nedved,46,39,85,6,3,0.5411764705882353,25.0,35.0
20052006,Daymond Langkow,51,53,104,7,3,0.49038461538461536,42.0,32.0
20052006,Mike Modano,69,56,125,5,3,0.552,18.0,20.0
20052006,Doug Weight,132,163,295,23,3,0.44745762711864406,55.0,7.0
20062007,Jeff O'Neill,144,105,249,74,2,0.5783132530120482,6.0,134.0
20062007,Daniel Bri√®re,540,549,1089,81,2,0.49586776859504134,103.0,39.0
20062007,Vyacheslav Kozlov,153,173,326,81,2,0.46932515337423314,139.0,127.0
20062007,Trevor Linden,107,104,211,80,2,0.5071090047393365,81.0,149.0
20062007,Jordan Staal,142,241,383,81,2,0.370757180156658,189.0,136.0
20062007,Josh Green,108,158,266,57,2,0.40601503759398494,183.0,148.0
20062007,Mike Zigomanis,568,442,1010,75,2,0.5623762376237624,15.0,33.0
20062007,Mike Sillinger,1004,704,1708,82,2,0.5878220140515222,3.0,2.0
20062007,Michal Handzus,89,84,173,8,2,0.5144508670520231,68.0,157.0
20062007,Mike York,327,377,704,66,2,0.46448863636363635,146.0,83.0
20062007,Jozef Stumpel,498,488,986,73,2,0.5050709939148073,86.0,47.0
20062007,Mike Richards,467,511,978,59,2,0.4775051124744376,134.0,58.0
20062007,Wes Walz,371,415,786,62,2,0.4720101781170484,137.0,75.0
20062007,Henrik Zetterberg,466,422,888,63,2,0.5247747747747747,52.0,59.0
20062007,R.J. Umberger,238,297,535,81,2,0.44485981308411215,168.0,104.0
20062007,Scott Gomez,628,576,1204,72,2,0.521594684385382,58.0,21.0
20062007,Pavel Datsyuk,475,370,845,79,2,0.5621301775147929,16.0,54.0
20062007,Erik Christensen,135,105,240,61,2,0.5625,14.0,138.0
20062007,Brian Willsie,91,110,201,81,2,0.4527363184079602,160.0,156.0
20062007,Eric Lindros,130,111,241,49,2,0.5394190871369294,33.0,140.0
20062007,Travis Green,104,93,197,31,2,0.5279187817258884,45.0,151.0
20062007,Paul Gaustad,204,182,386,54,2,0.5284974093264249,44.0,114.0
20062007,Craig Conroy,636,609,1245,80,2,0.5108433734939759,75.0,19.0
20062007,Alexander Svitov,472,456,928,76,2,0.5086206896551724,77.0,56.0
20062007,Dean McAmmond,299,378,677,81,2,0.44165435745937964,171.0,91.0
20062007,Jason Krog,128,103,231,23,2,0.5541125541125541,21.0,142.0
20062007,Martin Straka,86,127,213,77,2,0.40375586854460094,184.0,159.0
20062007,Toby Petersen,103,111,214,64,2,0.48130841121495327,128.0,152.0
20062007,Shawn Horcoff,720,702,1422,80,2,0.5063291139240507,82.0,13.0
20062007,Patrice Bergeron,798,762,1560,77,2,0.5115384615384615,72.0,9.0
20062007,Kyle Wellwood,164,127,291,48,2,0.563573883161512,13.0,125.0
20062007,Eric Belanger,640,566,1206,80,2,0.5306799336650083,39.0,18.0
20062007,Niko Kapanen,436,370,806,79,2,0.5409429280397022,32.0,65.0
20062007,Matt Stajan,454,531,985,82,2,0.46091370558375633,149.0,60.0
20062007,Stu Barnes,357,377,734,82,2,0.48637602179836514,119.0,79.0
20062007,Gilbert Brule,123,145,268,78,2,0.458955223880597,154.0,145.0
20062007,Brendan Shanahan,135,146,281,67,2,0.4804270462633452,130.0,138.0
20062007,Joe Nieuwendyk,111,96,207,15,2,0.5362318840579711,34.0,147.0
20062007,Vincent Lecavalier,770,883,1653,82,2,0.46581972171808833,143.0,11.0
20062007,Jarome Iginla,215,191,406,70,2,0.5295566502463054,43.0,111.0
20062007,Antoine Vermette,442,392,834,77,2,0.5299760191846523,40.0,63.0
20062007,Derek Armstrong,403,439,842,67,2,0.47862232779097386,131.0,71.0
20062007,Brett McLean,207,206,413,78,2,0.5012106537530266,94.0,113.0
20062007,Marcel Goc,364,295,659,78,2,0.5523520485584219,23.0,76.0
20062007,Jamie Lundmark,324,319,643,68,2,0.5038880248833593,89.0,84.0
20062007,Eric Staal,559,679,1238,82,2,0.45153473344103395,164.0,35.0
20062007,Dave Scatchard,202,183,385,46,2,0.5246753246753246,53.0,116.0
20062007,Saku Koivu,798,655,1453,81,2,0.5492085340674466,26.0,9.0
20062007,Sidney Crosby,839,847,1686,79,2,0.49762752075919336,101.0,5.0
20062007,Joe Sakic,726,642,1368,82,2,0.5307017543859649,38.0,12.0
20062007,Marc-Antoine Pouliot,172,181,353,46,2,0.48725212464589235,117.0,124.0
20062007,Glen Metropolit,178,182,360,77,2,0.49444444444444446,106.0,123.0
20062007,Shane Doan,68,106,174,73,2,0.39080459770114945,185.0,165.0
20062007,Daniel Cleary,210,201,411,71,2,0.5109489051094891,74.0,112.0
20062007,Scott Nichol,361,262,623,59,2,0.579454253611557,5.0,77.0
20062007,Brad Richards,812,768,1580,82,2,0.5139240506329114,71.0,7.0
20062007,Owen Nolan,125,113,238,76,2,0.5252100840336135,51.0,144.0
20062007,Matt Cullen,619,515,1134,80,2,0.5458553791887125,28.0,25.0
20062007,Dainius Zubrus,572,593,1165,79,2,0.49098712446351933,116.0,32.0
20062007,Sergei Fedorov,356,324,680,73,2,0.5235294117647059,54.0,80.0
20062007,Radek Bonk,597,601,1198,74,2,0.498330550918197,98.0,27.0
20062007,John Madden,680,686,1366,74,2,0.4978038067349927,100.0,15.0
20062007,Marc Chouinard,191,201,392,42,2,0.4872448979591837,118.0,118.0
20062007,Mike Comrie,224,230,454,65,2,0.4933920704845815,109.0,108.0
20062007,Jeff Carter,482,580,1062,62,2,0.4538606403013183,158.0,50.0
20062007,Martin Lapointe,180,161,341,82,2,0.5278592375366569,46.0,122.0
20062007,Jamal Mayers,248,184,432,80,2,0.5740740740740741,8.0,100.0
20062007,Dan Hinote,85,88,173,41,2,0.4913294797687861,114.0,160.0
20062007,Sergei Brylin,126,151,277,82,2,0.4548736462093863,156.0,143.0
20062007,Jeremy Roenick,306,289,595,70,2,0.5142857142857142,69.0,89.0
20062007,Peter Forsberg,478,479,957,57,2,0.4994775339602926,96.0,52.0
20062007,Ryan Potulny,121,157,278,35,2,0.4352517985611511,173.0,146.0
20062007,Maxim Lapierre,192,233,425,46,2,0.45176470588235296,163.0,117.0
20062007,Sean Avery,143,147,290,84,2,0.49310344827586206,111.0,135.0
20062007,Geoff Sanderson,68,95,163,58,2,0.4171779141104294,178.0,165.0
20062007,Shawn Bates,242,213,455,48,2,0.5318681318681319,37.0,103.0
20062007,Mark Mowers,267,326,593,78,2,0.4502529510961214,166.0,98.0
20062007,Petr Nedved,266,248,514,40,2,0.5175097276264592,65.0,99.0
20062007,Alex Kovalev,75,87,162,73,2,0.46296296296296297,147.0,163.0
20062007,Josef Vasicek,303,296,599,63,2,0.5058430717863105,84.0,90.0
20062007,Phil Kessel,152,221,373,70,2,0.4075067024128686,181.0,128.0
20062007,Ryan Johnson,291,234,525,59,2,0.5542857142857143,20.0,95.0
20062007,Andreas Karlsson,129,157,286,53,2,0.45104895104895104,165.0,141.0
20062007,Tuomo Ruutu,148,199,347,71,2,0.4265129682997118,176.0,131.0
20062007,Valtteri Filppula,149,118,267,73,2,0.5580524344569289,17.0,130.0
20062007,Paul Stastny,594,632,1226,82,2,0.48450244698205547,123.0,28.0
20062007,Michael Nylander,501,553,1054,79,2,0.47533206831119545,136.0,46.0
20062007,Ian Laperriere,182,207,389,81,2,0.46786632390745503,141.0,121.0
20062007,Manny Malhotra,621,506,1127,82,2,0.5510204081632653,25.0,23.0
20062007,Chris Drury,948,665,1613,77,2,0.587724736515809,4.0,4.0
20062007,Jason Spezza,668,593,1261,67,2,0.5297383029341792,41.0,16.0
20062007,Mike Fisher,620,571,1191,68,2,0.5205709487825357,61.0,24.0
20062007,Chris Gratton,293,224,517,81,2,0.5667311411992263,10.0,93.0
20062007,Ryan Getzlaf,439,449,888,82,2,0.49436936936936937,107.0,64.0
20062007,Henrik Sedin,641,579,1220,82,2,0.5254098360655738,50.0,17.0
20062007,Jason Williams,87,117,204,78,2,0.4264705882352941,177.0,158.0
20062007,Richard Park,85,133,218,82,2,0.38990825688073394,186.0,160.0
20062007,Tomas Plekanec,560,599,1159,81,2,0.4831751509922347,125.0,34.0
20062007,Wyatt Smith,221,287,508,61,2,0.43503937007874016,174.0,110.0
20062007,Tim Taylor,225,175,400,71,2,0.5625,14.0,107.0
20062007,Todd Marchant,351,296,647,56,2,0.5425038639876353,30.0,81.0
20062007,Boyd Gordon,632,582,1214,71,2,0.5205930807248764,60.0,20.0
20062007,Olli Jokinen,476,598,1074,82,2,0.44320297951582865,170.0,53.0
20062007,Evgeni Malkin,315,413,728,78,2,0.4326923076923077,175.0,87.0
20062007,Eric Perrin,207,200,407,82,2,0.5085995085995086,78.0,113.0
20062007,Jay McClement,442,397,839,81,2,0.5268176400476758,47.0,63.0
20062007,Tyler Arnason,185,237,422,82,2,0.43838862559241704,172.0,120.0
20062007,Jim Dowd,142,132,274,66,2,0.5182481751824818,63.0,136.0
20062007,Mats Sundin,988,802,1790,75,2,0.5519553072625698,24.0,3.0
20062007,Jiri Novotny,247,279,526,68,2,0.4695817490494297,138.0,101.0
20062007,Doug Weight,489,536,1025,82,2,0.4770731707317073,135.0,48.0
20062007,Joe Thornton,778,744,1522,82,2,0.5111695137976346,73.0,10.0
20062007,Randy Robitaille,426,373,799,78,2,0.5331664580725908,36.0,66.0
20062007,Dan Fritsche,146,150,296,59,2,0.49324324324324326,110.0,132.0
20062007,Alexei Yashin,242,285,527,58,2,0.45920303605313095,153.0,103.0
20062007,Kris Beech,360,384,744,64,2,0.4838709677419355,124.0,78.0
20062007,Anze Kopitar,555,649,1204,72,2,0.46096345514950166,148.0,36.0
20062007,Pavol Demitra,245,268,513,71,2,0.4775828460038986,132.0,102.0
20062007,Steve Begin,79,80,159,52,2,0.4968553459119497,102.0,161.0
20062007,Michael Peca,307,308,615,35,2,0.4991869918699187,97.0,88.0
20062007,Matthew Lombardi,474,491,965,81,2,0.49119170984455957,115.0,55.0
20062007,Patrik Stefan,105,113,218,41,2,0.481651376146789,127.0,150.0
20062007,Michael Holmqvist,72,89,161,63,2,0.4472049689440994,167.0,164.0
20062007,Jakub Klepis,76,108,184,41,2,0.41304347826086957,179.0,162.0
20062007,Brian Sutherby,382,380,762,69,2,0.5013123359580053,93.0,74.0
20062007,Ryan Kesler,318,372,690,48,2,0.4608695652173913,150.0,85.0
20062007,Vernon Fiddler,351,329,680,72,2,0.5161764705882353,67.0,81.0
20062007,Brad Richardson,146,212,358,73,2,0.40782122905027934,180.0,132.0
20062007,Brendan Morrison,625,605,1230,82,2,0.508130081300813,79.0,22.0
20062007,Joe Pavelski,189,200,389,46,2,0.48586118251928023,120.0,119.0
20062007,Wayne Primeau,421,430,851,78,2,0.49471210340775557,105.0,68.0
20062007,Jason Ward,87,127,214,70,2,0.40654205607476634,182.0,158.0
20062007,Kevyn Adams,141,171,312,68,2,0.4519230769230769,162.0,137.0
20062007,Samuel Pahlsson,802,721,1523,82,2,0.5265922521339461,48.0,8.0
20062007,Patrick Marleau,350,343,693,77,2,0.5050505050505051,87.0,82.0
20062007,Michael Cammalleri,163,138,301,81,2,0.5415282392026578,31.0,126.0
20062007,David Vyborny,102,167,269,82,2,0.379182156133829,188.0,153.0
20062007,Max Talbot,401,502,903,75,2,0.4440753045404208,169.0,72.0
20062007,Bobby Holik,820,607,1427,82,2,0.5746320953048353,7.0,6.0
20062007,Steve Rucchin,446,418,864,47,2,0.5162037037037037,66.0,62.0
20062007,Teemu Selanne,178,173,351,82,2,0.5071225071225072,80.0,123.0
20062007,Brooks Laich,292,271,563,73,2,0.5186500888099467,62.0,94.0
20062007,Geoff Platt,95,73,168,26,2,0.5654761904761905,11.0,155.0
20062007,Miroslav Satan,91,73,164,81,2,0.5548780487804879,19.0,156.0
20062007,Jim Slater,203,170,373,74,2,0.5442359249329759,29.0,115.0
20062007,Jussi Jokinen,145,133,278,82,2,0.5215827338129496,59.0,133.0
20062007,Robert Lang,401,411,812,81,2,0.4938423645320197,108.0,72.0
20062007,Travis Zajac,424,480,904,80,2,0.4690265486725664,140.0,67.0
20062007,Stephane Yelle,407,401,808,56,2,0.5037128712871287,90.0,70.0
20062007,Marc Savard,712,708,1420,82,2,0.5014084507042254,92.0,14.0
20062007,Petr Sykora,222,240,462,82,2,0.4805194805194805,129.0,109.0
20062007,Jerred Smithson,237,183,420,64,2,0.5642857142857143,12.0,105.0
20062007,Dominic Moore,391,353,744,69,2,0.5255376344086021,49.0,73.0
20062007,Todd White,517,534,1051,77,2,0.49191246431969554,113.0,42.0
20062007,Yanic Perreault,506,300,806,66,2,0.6277915632754343,1.0,43.0
20062007,Freddy Modin,236,272,508,79,2,0.4645669291338583,145.0,106.0
20062007,Blair Betts,620,566,1186,82,2,0.5227655986509275,56.0,24.0
20062007,Gregory Campbell,266,322,588,79,2,0.4523809523809524,161.0,99.0
20062007,Mikko Koivu,593,572,1165,82,2,0.5090128755364807,76.0,29.0
20062007,Marty Reasoner,418,347,765,72,2,0.5464052287581699,27.0,69.0
20062007,Jason Arnott,579,566,1145,68,2,0.5056768558951965,85.0,31.0
20062007,Daymond Langkow,538,635,1173,81,2,0.45865302642796246,155.0,40.0
20062007,Dallas Drake,107,95,202,60,2,0.5297029702970297,42.0,149.0
20062007,Stephen Weiss,543,639,1182,74,2,0.4593908629441624,152.0,38.0
20062007,Viktor Kozlov,180,282,462,81,2,0.38961038961038963,187.0,122.0
20062007,Brian Rolston,134,161,295,78,2,0.4542372881355932,157.0,139.0
20062007,Patrick Sharp,469,539,1008,80,2,0.4652777777777778,144.0,57.0
20062007,Denis Arkhipov,483,498,981,79,2,0.4923547400611621,112.0,49.0
20062007,Jeff Halpern,588,547,1135,76,2,0.5180616740088105,64.0,30.0
20062007,Byron Ritchie,141,141,282,64,2,0.5,95.0,137.0
20062007,Craig MacDonald,85,93,178,25,2,0.47752808988764045,133.0,160.0
20062007,David Legwand,502,606,1108,78,2,0.45306859205776173,159.0,45.0
20062007,Steve Reinprecht,281,256,537,49,2,0.5232774674115456,55.0,96.0
20062007,Ben Guite,192,196,388,39,2,0.4948453608247423,104.0,117.0
20062007,Rod Brind'Amour,1213,834,2047,78,2,0.5925744992672203,2.0,1.0
20062007,Chad Kilger,91,107,198,82,2,0.4595959595959596,151.0,156.0
20062007,Brad Boyes,151,162,313,81,2,0.48242811501597443,126.0,129.0
20062007,Jarret Stoll,501,400,901,51,2,0.5560488346281909,18.0,46.0
20062007,Chris Kelly,281,283,564,82,2,0.49822695035460995,99.0,96.0
20062007,Keith Tkachuk,519,507,1026,79,2,0.5058479532163743,83.0,41.0
20062007,Petr Cajanek,271,268,539,77,2,0.5027829313543599,91.0,97.0
20062007,Andy McDonald,503,405,908,82,2,0.5539647577092511,22.0,44.0
20062007,Mike Ribeiro,316,362,678,81,2,0.46607669616519176,142.0,86.0
20062007,Bryan Smolinski,611,601,1212,82,2,0.5041254125412541,88.0,26.0
20062007,Trevor Letowski,101,107,208,61,2,0.4855769230769231,121.0,154.0
20062007,Mike Modano,479,439,918,59,2,0.5217864923747276,57.0,51.0
20062007,Kris Draper,712,530,1242,81,2,0.573268921095008,9.0,14.0
20062007,John Pohl,295,258,553,74,2,0.5334538878842676,35.0,92.0
20062007,Derek Roy,548,581,1129,75,2,0.4853852967227635,122.0,37.0
20062007,Curtis Brown,453,428,881,78,2,0.5141884222474461,70.0,61.0
20062007,Daniel Bri√®re,104,87,191,16,3,0.5445026178010471,17.0,15.0
20062007,Trevor Linden,16,15,31,12,3,0.5161290322580645,31.0,49.0
20062007,Josh Green,25,41,66,9,3,0.3787878787878788,66.0,45.0
20062007,Mike Sillinger,83,39,122,5,3,0.680327868852459,2.0,19.0
20062007,Jordan Staal,13,27,40,5,3,0.325,67.0,51.0
20062007,Wes Walz,17,18,35,5,3,0.4857142857142857,39.0,48.0
20062007,Henrik Zetterberg,115,102,217,18,3,0.5299539170506913,24.0,11.0
20062007,Scott Gomez,104,93,197,11,3,0.5279187817258884,26.0,15.0
20062007,Pavel Datsyuk,123,98,221,18,3,0.5565610859728507,13.0,10.0
20062007,Peter Forsberg,33,31,64,5,3,0.515625,32.0,40.0
20062007,Paul Gaustad,29,27,56,7,3,0.5178571428571429,30.0,42.0
20062007,Dean McAmmond,50,63,113,18,3,0.4424778761061947,55.0,30.0
20062007,Keith Tkachuk,31,37,68,4,3,0.45588235294117646,50.0,41.0
20062007,Matt Cullen,79,79,158,10,3,0.5,35.0,20.0
20062007,Joel Lundqvist,29,7,36,7,3,0.8055555555555556,1.0,42.0
20062007,Sidney Crosby,61,55,116,5,3,0.5258620689655172,28.0,27.0
20062007,Tim Connolly,58,70,128,16,3,0.453125,51.0,29.0
20062007,Vincent Lecavalier,72,82,154,6,3,0.4675324675324675,45.0,22.0
20062007,John Madden,132,118,250,11,3,0.528,25.0,8.0
20062007,Mike Fisher,160,137,297,20,3,0.5387205387205387,20.0,6.0
20062007,Jason Spezza,194,222,416,20,3,0.46634615384615385,46.0,3.0
20062007,Chris Drury,193,185,378,16,3,0.5105820105820106,34.0,4.0
20062007,Antoine Vermette,207,143,350,20,3,0.5914285714285714,6.0,2.0
20062007,Ryan Getzlaf,138,178,316,21,3,0.43670886075949367,58.0,7.0
20062007,Henrik Sedin,114,118,232,12,3,0.49137931034482757,37.0,12.0
20062007,Valtteri Filppula,40,38,78,18,3,0.5128205128205128,33.0,35.0
20062007,Marcel Goc,76,54,130,11,3,0.5846153846153846,8.0,21.0
20062007,Richard Park,14,22,36,5,3,0.3888888888888889,65.0,50.0
20062007,Bryan Smolinski,90,105,195,12,3,0.46153846153846156,47.0,17.0
20062007,Randy Robitaille,41,37,78,5,3,0.5256410256410257,29.0,34.0
20062007,Daniel Cleary,36,25,61,18,3,0.5901639344262295,7.0,37.0
20062007,Brad Richards,50,52,102,6,3,0.49019607843137253,38.0,30.0
20062007,Scott Nichol,19,11,30,5,3,0.6333333333333333,4.0,47.0
20062007,Michael Nylander,70,100,170,10,3,0.4117647058823529,61.0,23.0
20062007,Matthew Lombardi,16,23,39,6,3,0.41025641025641024,62.0,49.0
20062007,Bobby Holik,28,34,62,4,3,0.45161290322580644,52.0,43.0
20062007,Max Talbot,42,35,77,5,3,0.5454545454545454,16.0,33.0
20062007,Jerred Smithson,20,16,36,5,3,0.5555555555555556,14.0,46.0
20062007,David Legwand,35,52,87,5,3,0.40229885057471265,63.0,38.0
20062007,Jeff Halpern,46,50,96,7,3,0.4791666666666667,41.0,32.0
20062007,Curtis Brown,59,66,125,11,3,0.472,43.0,28.0
20062007,Derek Roy,99,118,217,16,3,0.45622119815668205,49.0,16.0
20062007,Kris Draper,182,134,316,18,3,0.5759493670886076,10.0,5.0
20062007,Joe Thornton,106,118,224,11,3,0.4732142857142857,42.0,14.0
20062007,Pavol Demitra,26,23,49,5,3,0.5306122448979592,23.0,44.0
20062007,Teemu Selanne,66,47,113,21,3,0.584070796460177,9.0,25.0
20062007,Robert Lang,66,101,167,18,3,0.39520958083832336,64.0,25.0
20062007,Travis Zajac,65,82,147,11,3,0.4421768707482993,56.0,26.0
20062007,Sean Avery,68,57,125,10,3,0.544,18.0,24.0
20062007,Mike Modano,89,80,169,7,3,0.5266272189349113,27.0,18.0
20062007,Evgeni Malkin,7,24,31,5,3,0.22580645161290322,69.0,53.0
20062007,Eric Perrin,14,18,32,6,3,0.4375,57.0,50.0
20062007,Samuel Pahlsson,246,216,462,21,3,0.5324675324675324,22.0,1.0
20062007,Craig Conroy,41,56,97,6,3,0.422680412371134,59.0,34.0
20062007,Stephane Yelle,61,47,108,6,3,0.5648148148148148,11.0,27.0
20062007,Eric Belanger,29,23,52,4,3,0.5576923076923077,12.0,42.0
20062007,Blair Betts,68,58,126,10,3,0.5396825396825397,19.0,24.0
20062007,Mikko Koivu,49,32,81,5,3,0.6049382716049383,5.0,31.0
20062007,Mike Ribeiro,37,46,83,7,3,0.4457831325301205,54.0,36.0
20062007,Tim Taylor,16,14,30,6,3,0.5333333333333333,21.0,49.0
20062007,Todd Marchant,31,35,66,11,3,0.4696969696969697,44.0,41.0
20062007,Patrick Marleau,50,52,102,11,3,0.49019607843137253,38.0,30.0
20062007,Jussi Jokinen,20,11,31,4,3,0.6451612903225806,3.0,46.0
20062007,Todd White,26,28,54,4,3,0.48148148148148145,40.0,44.0
20062007,Andy McDonald,128,105,233,21,3,0.5493562231759657,15.0,9.0
20062007,Jim Dowd,14,17,31,11,3,0.45161290322580644,52.0,50.0
20062007,Brendan Morrison,112,113,225,12,3,0.49777777777777776,36.0,13.0
20062007,Wayne Primeau,17,20,37,6,3,0.4594594594594595,48.0,48.0
20062007,Joe Pavelski,19,19,38,6,3,0.5,35.0,47.0
20062007,Daymond Langkow,34,42,76,6,3,0.4473684210526316,53.0,39.0
20062007,Viktor Kozlov,10,26,36,5,3,0.2777777777777778,68.0,52.0
20062007,Jason Arnott,37,52,89,5,3,0.4157303370786517,60.0,36.0
20072008,Patrick O'Sullivan,203,258,461,82,2,0.4403470715835141,152.0,107.0
20072008,Owen Nolan,181,165,346,77,2,0.523121387283237,50.0,116.0
20072008,Jiri Novotny,375,416,791,65,2,0.4740834386852086,121.0,71.0
20072008,Jeff Halpern,381,352,733,83,2,0.519781718963165,59.0,69.0
20072008,Ryan Carter,184,115,299,34,2,0.6153846153846154,2.0,113.0
20072008,Trevor Linden,158,158,316,59,2,0.5,92.0,121.0
20072008,Todd White,543,623,1166,74,2,0.46569468267581476,128.0,41.0
20072008,Jordan Staal,507,695,1202,82,2,0.42179700499168055,162.0,49.0
20072008,Mike Zigomanis,196,132,328,33,2,0.5975609756097561,3.0,109.0
20072008,Mike Sillinger,578,449,1027,52,2,0.5628042843232717,13.0,31.0
20072008,Jozef Stumpel,329,314,643,52,2,0.5116640746500778,71.0,82.0
20072008,Mike Richards,698,683,1381,73,2,0.5054308472121651,82.0,14.0
20072008,Keith Aucoin,124,203,327,38,2,0.37920489296636084,174.0,130.0
20072008,Henrik Zetterberg,666,544,1210,75,2,0.5504132231404959,24.0,18.0
20072008,Mikhail Grabovski,51,103,154,24,2,0.33116883116883117,175.0,155.0
20072008,Torrey Mitchell,342,350,692,82,2,0.49421965317919075,97.0,79.0
20072008,Rod Pelley,150,171,321,58,2,0.4672897196261682,127.0,123.0
20072008,Kevyn Adams,103,104,207,27,2,0.4975845410628019,94.0,141.0
20072008,Pavel Datsyuk,453,380,833,82,2,0.5438175270108043,34.0,56.0
20072008,Byron Ritchie,262,253,515,71,2,0.5087378640776699,76.0,97.0
20072008,Andrew Cogliano,214,328,542,82,2,0.3948339483394834,172.0,105.0
20072008,Paul Gaustad,640,525,1165,82,2,0.5493562231759657,27.0,21.0
20072008,Dean McAmmond,112,147,259,68,2,0.43243243243243246,157.0,133.0
20072008,Sergei Fedorov,562,449,1011,68,2,0.5558852621167161,20.0,36.0
20072008,Mark Bell,74,105,179,35,2,0.4134078212290503,169.0,151.0
20072008,Shawn Horcoff,487,476,963,53,2,0.505711318795431,80.0,51.0
20072008,Kyle Brodziak,153,144,297,80,2,0.5151515151515151,62.0,122.0
20072008,Sam Gagner,125,174,299,79,2,0.4180602006688963,167.0,129.0
20072008,Patrice Bergeron,88,87,175,10,2,0.5028571428571429,88.0,144.0
20072008,Jussi Jokinen,178,163,341,72,2,0.5219941348973607,53.0,118.0
20072008,Michael Nylander,263,272,535,40,2,0.491588785046729,102.0,96.0
20072008,Radek Bonk,457,422,879,79,2,0.5199089874857793,58.0,54.0
20072008,Chris Drury,746,613,1359,82,2,0.5489330389992642,28.0,8.0
20072008,Kyle Wellwood,178,147,325,59,2,0.5476923076923077,29.0,118.0
20072008,Erik Christensen,277,197,474,59,2,0.5843881856540084,8.0,92.0
20072008,Saku Koivu,701,640,1341,77,2,0.522744220730798,52.0,13.0
20072008,Sidney Crosby,567,536,1103,53,2,0.514052583862194,67.0,33.0
20072008,Vladimir Sobotka,120,127,247,48,2,0.48582995951417,110.0,131.0
20072008,Nik Antropov,114,157,271,72,2,0.42066420664206644,163.0,132.0
20072008,Doug Weight,290,324,614,67,2,0.4723127035830619,124.0,90.0
20072008,Jochen Hecht,380,525,905,75,2,0.4198895027624309,165.0,70.0
20072008,Mike Fisher,618,612,1230,79,2,0.5024390243902439,90.0,23.0
20072008,Jason Spezza,729,716,1445,76,2,0.5044982698961937,85.0,9.0
20072008,Joe Sakic,296,290,586,44,2,0.5051194539249146,83.0,88.0
20072008,Andreas Karlsson,182,151,333,58,2,0.5465465465465466,31.0,115.0
20072008,Viktor Kozlov,203,239,442,81,2,0.4592760180995475,135.0,107.0
20072008,Valtteri Filppula,314,307,621,78,2,0.5056360708534622,81.0,84.0
20072008,Eric Staal,767,941,1708,82,2,0.4490632318501171,147.0,7.0
20072008,Todd Marchant,331,342,673,75,2,0.4918276374442793,100.0,81.0
20072008,Daniel Bri√®re,631,619,1250,79,2,0.5048,84.0,22.0
20072008,Chris Gratton,337,281,618,60,2,0.5453074433656958,33.0,80.0
20072008,Matt Stajan,615,678,1293,82,2,0.4756380510440835,119.0,24.0
20072008,Brett McLean,296,328,624,67,2,0.47435897435897434,120.0,88.0
20072008,Andy McDonald,527,421,948,82,2,0.5559071729957806,19.0,45.0
20072008,Manny Malhotra,683,475,1158,71,2,0.5898100172711571,5.0,16.0
20072008,Antoine Vermette,690,527,1217,81,2,0.5669679539852095,11.0,15.0
20072008,Craig MacDonald,202,204,406,65,2,0.4975369458128079,95.0,108.0
20072008,Richard Park,314,312,626,82,2,0.5015974440894568,91.0,84.0
20072008,Tomas Plekanec,683,698,1381,81,2,0.4945691527878349,96.0,16.0
20072008,Shane Doan,77,110,187,80,2,0.4117647058823529,170.0,149.0
20072008,Kris Beech,144,132,276,25,2,0.5217391304347826,54.0,125.0
20072008,Scott Nichol,441,297,738,73,2,0.5975609756097561,3.0,57.0
20072008,Jay McClement,366,334,700,81,2,0.5228571428571429,51.0,72.0
20072008,Mats Sundin,945,768,1713,74,2,0.5516637478108581,21.0,1.0
20072008,Tyler Arnason,375,417,792,70,2,0.4734848484848485,122.0,71.0
20072008,Eric Belanger,587,608,1195,75,2,0.49121338912133894,104.0,29.0
20072008,Bryan Little,228,277,505,48,2,0.4514851485148515,142.0,103.0
20072008,Stu Barnes,343,284,627,79,2,0.5470494417862839,30.0,78.0
20072008,Jeff Giuliano,108,131,239,53,2,0.45188284518828453,141.0,136.0
20072008,Maxim Lapierre,259,268,527,53,2,0.49146110056925996,103.0,98.0
20072008,Jaroslav Hlinka,167,216,383,63,2,0.4360313315926893,155.0,119.0
20072008,Ryan Johnson,438,365,803,79,2,0.5454545454545454,32.0,58.0
20072008,Phil Kessel,138,188,326,82,2,0.4233128834355828,159.0,127.0
20072008,Jeff Carter,657,721,1378,82,2,0.47677793904209,117.0,19.0
20072008,Sergei Brylin,88,104,192,82,2,0.4583333333333333,136.0,144.0
20072008,Kyle Chipchura,139,178,317,36,2,0.4384858044164038,153.0,126.0
20072008,Joel Lundqvist,107,117,224,55,2,0.47767857142857145,115.0,137.0
20072008,Martin Hanzal,470,549,1019,72,2,0.46123650637880276,132.0,53.0
20072008,Joel Perrault,294,305,599,49,2,0.49081803005008345,105.0,89.0
20072008,Yanic Perreault,294,163,457,53,2,0.6433260393873085,1.0,89.0
20072008,John Madden,786,677,1463,80,2,0.5372522214627478,38.0,6.0
20072008,Andy Hilbert,99,121,220,70,2,0.45,145.0,142.0
20072008,Mike Comrie,564,663,1227,76,2,0.45965770171149145,134.0,34.0
20072008,Brandon Dubinsky,512,483,995,82,2,0.5145728643216081,63.0,47.0
20072008,Ryan Getzlaf,545,607,1152,77,2,0.4730902777777778,123.0,40.0
20072008,Henrik Sedin,643,726,1369,82,2,0.46968590211833455,126.0,20.0
20072008,Marcel Goc,107,101,208,51,2,0.5144230769230769,65.0,137.0
20072008,Paul Stastny,561,540,1101,66,2,0.5095367847411444,74.0,37.0
20072008,Boyd Gordon,504,400,904,67,2,0.5575221238938053,16.0,50.0
20072008,Mike York,104,101,205,63,2,0.5073170731707317,77.0,140.0
20072008,Olli Jokinen,404,534,938,82,2,0.43070362473347545,158.0,62.0
20072008,Evgeni Malkin,350,540,890,82,2,0.39325842696629215,173.0,77.0
20072008,Tim Connolly,222,241,463,48,2,0.4794816414686825,114.0,104.0
20072008,Vincent Lecavalier,815,856,1671,81,2,0.48773189706762415,107.0,4.0
20072008,Jarome Iginla,245,200,445,82,2,0.550561797752809,23.0,99.0
20072008,Derek Armstrong,380,370,750,77,2,0.5066666666666667,78.0,70.0
20072008,T.J. Hensick,108,148,256,31,2,0.421875,161.0,136.0
20072008,Michael Peca,571,513,1084,65,2,0.5267527675276753,46.0,32.0
20072008,Jamal Mayers,384,299,683,80,2,0.5622254758418741,14.0,67.0
20072008,Robert Lang,593,524,1117,76,2,0.5308863025962399,41.0,28.0
20072008,Todd Marchant,331,342,673,75,2,0.4918276374442793,100.0,81.0
20072008,Mats Sundin,945,768,1713,74,2,0.5516637478108581,21.0,1.0
20072008,Tyler Arnason,375,417,792,70,2,0.4734848484848485,122.0,71.0
20072008,Jay McClement,366,334,700,81,2,0.5228571428571429,51.0,72.0
20072008,Jeff Taffe,74,78,152,45,2,0.4868421052631579,109.0,151.0
20072008,Steve Ott,183,128,311,73,2,0.5884244372990354,6.0,114.0
20072008,Pavol Demitra,403,487,890,68,2,0.45280898876404496,140.0,63.0
20072008,James Sheppard,272,383,655,78,2,0.4152671755725191,168.0,93.0
20072008,Matthew Lombardi,455,500,955,82,2,0.47643979057591623,118.0,55.0
20072008,Patrik Elias,354,422,776,74,2,0.45618556701030927,137.0,76.0
20072008,Adam Mair,164,197,361,72,2,0.45429362880886426,139.0,120.0
20072008,Ryan Kesler,720,638,1358,80,2,0.5301914580265096,43.0,11.0
20072008,Patrick Rissmiller,109,105,214,79,2,0.5093457943925234,75.0,135.0
20072008,Vernon Fiddler,193,191,384,79,2,0.5026041666666666,89.0,110.0
20072008,Matt Cullen,364,285,649,59,2,0.5608628659476117,15.0,73.0
20072008,Dustin Penner,104,85,189,82,2,0.5502645502645502,25.0,140.0
20072008,Brendan Morrison,167,203,370,39,2,0.45135135135135135,143.0,119.0
20072008,Joe Pavelski,268,233,501,82,2,0.5349301397205589,39.0,95.0
20072008,Craig Conroy,726,685,1411,79,2,0.5145287030474841,64.0,10.0
20072008,Keith Tkachuk,552,566,1118,79,2,0.4937388193202147,98.0,39.0
20072008,Dave Bolland,179,206,385,39,2,0.4649350649350649,129.0,117.0
20072008,Samuel Pahlsson,586,480,1066,56,2,0.549718574108818,26.0,30.0
20072008,Patrick Marleau,317,288,605,78,2,0.5239669421487604,49.0,83.0
20072008,Michael Cammalleri,206,174,380,63,2,0.5421052631578948,35.0,106.0
20072008,Josef Vasicek,615,490,1105,81,2,0.5565610859728507,18.0,24.0
20072008,Max Talbot,231,282,513,63,2,0.4502923976608187,144.0,102.0
20072008,Eric Perrin,380,337,717,81,2,0.5299860529986054,44.0,70.0
20072008,Bobby Holik,877,625,1502,82,2,0.5838881491344874,9.0,2.0
20072008,Daniel Winnik,65,89,154,79,2,0.42207792207792205,160.0,153.0
20072008,Brooks Laich,281,315,596,82,2,0.4714765100671141,125.0,91.0
20072008,Adam Burish,111,153,264,81,2,0.42045454545454547,164.0,134.0
20072008,Jonathan Toews,509,447,956,64,2,0.5324267782426778,40.0,48.0
20072008,Jim Slater,191,176,367,69,2,0.5204359673024523,57.0,111.0
20072008,Travis Zajac,528,504,1032,82,2,0.5116279069767442,72.0,44.0
20072008,Stephane Yelle,190,191,381,74,2,0.49868766404199477,93.0,112.0
20072008,Marc Savard,802,753,1555,74,2,0.5157556270096463,61.0,5.0
20072008,David Krejci,306,329,635,56,2,0.4818897637795276,112.0,85.0
20072008,Niko Kapanen,420,386,806,79,2,0.5210918114143921,55.0,59.0
20072008,Jerred Smithson,298,274,572,81,2,0.5209790209790209,56.0,87.0
20072008,Jason Jaffray,84,92,176,19,2,0.4772727272727273,116.0,146.0
20072008,Vinny Prospal,146,116,262,80,2,0.5572519083969466,17.0,124.0
20072008,Blair Betts,388,383,771,75,2,0.503242542153048,87.0,65.0
20072008,Gregory Campbell,235,225,460,81,2,0.5108695652173914,73.0,101.0
20072008,Mikko Koivu,542,490,1032,57,2,0.5251937984496124,48.0,42.0
20072008,Nicklas Backstrom,405,469,874,82,2,0.4633867276887872,131.0,61.0
20072008,Marty Reasoner,478,428,906,82,2,0.5275938189845475,45.0,52.0
20072008,Glen Metropolit,613,629,1242,82,2,0.49355877616747185,99.0,26.0
20072008,Bryan Smolinski,382,356,738,64,2,0.5176151761517616,60.0,68.0
20072008,Jason Arnott,614,646,1260,79,2,0.4873015873015873,108.0,25.0
20072008,Daymond Langkow,357,460,817,80,2,0.4369645042839657,154.0,75.0
20072008,Stephen Weiss,613,585,1198,74,2,0.511686143572621,70.0,26.0
20072008,David Steckel,507,393,900,67,2,0.5633333333333334,12.0,49.0
20072008,Brian Rolston,67,98,165,81,2,0.40606060606060607,171.0,152.0
20072008,Patrick Sharp,305,289,594,80,2,0.5134680134680135,68.0,86.0
20072008,Jim Dowd,240,206,446,73,2,0.5381165919282511,37.0,100.0
20072008,Kamil Kreps,411,352,763,76,2,0.5386631716906947,36.0,60.0
20072008,Scott Gomez,612,553,1165,81,2,0.5253218884120172,47.0,27.0
20072008,David Legwand,305,395,700,65,2,0.4357142857142857,156.0,86.0
20072008,Steve Reinprecht,516,504,1020,81,2,0.5058823529411764,79.0,46.0
20072008,Ben Guite,386,419,805,79,2,0.4795031055900621,113.0,66.0
20072008,Rod Brind'Amour,851,609,1460,59,2,0.5828767123287671,10.0,3.0
20072008,Michal Handzus,532,635,1167,82,2,0.45586975149957154,138.0,43.0
20072008,Brian Sutherby,128,150,278,50,2,0.460431654676259,133.0,128.0
20072008,Jarret Stoll,677,552,1229,81,2,0.5508543531326282,22.0,17.0
20072008,Peter Mueller,105,146,251,81,2,0.41832669322709165,166.0,139.0
20072008,Chris Kelly,86,76,162,75,2,0.5308641975308642,42.0,145.0
20072008,Dominic Moore,362,342,704,68,2,0.5142045454545454,66.0,74.0
20072008,Mike Ribeiro,397,486,883,76,2,0.44960362400906,146.0,64.0
20072008,Trevor Letowski,269,333,602,75,2,0.446843853820598,148.0,94.0
20072008,Brad Richards,527,547,1074,74,2,0.49068901303538176,106.0,45.0
20072008,Mike Modano,563,582,1145,82,2,0.49170305676855897,101.0,35.0
20072008,Brad Boyes,105,131,236,82,2,0.4449152542372881,150.0,139.0
20072008,Adam Hall,146,144,290,46,2,0.503448275862069,86.0,124.0
20072008,Ales Kotalik,98,122,220,79,2,0.44545454545454544,149.0,143.0
20072008,Kris Draper,553,391,944,65,2,0.5858050847457628,7.0,38.0
20072008,Mike Rupp,75,80,155,64,2,0.4838709677419355,111.0,150.0
20072008,Alexander Steen,59,120,179,76,2,0.329608938547486,176.0,154.0
20072008,Derek Roy,713,680,1393,78,2,0.5118449389806173,69.0,12.0
20072008,Curtis Brown,106,73,179,33,2,0.5921787709497207,4.0,138.0
20072008,Jake Dowell,79,91,170,19,2,0.4647058823529412,130.0,148.0
20072008,Jeremy Roenick,83,105,188,69,2,0.44148936170212766,151.0,147.0
20072008,Owen Nolan,12,21,33,7,3,0.36363636363636365,70.0,58.0
20072008,Jordan Staal,153,145,298,20,3,0.5134228187919463,31.0,5.0
20072008,Ryan Carter,22,20,42,6,3,0.5238095238095238,30.0,52.0
20072008,Mike Richards,163,143,306,17,3,0.5326797385620915,24.0,4.0
20072008,Henrik Zetterberg,197,171,368,22,3,0.5353260869565217,21.0,3.0
20072008,Torrey Mitchell,69,55,124,13,3,0.5564516129032258,13.0,22.0
20072008,Pavel Datsyuk,66,55,121,22,3,0.5454545454545454,18.0,23.0
20072008,Darren Helm,39,53,92,18,3,0.42391304347826086,62.0,40.0
20072008,Dean McAmmond,21,24,45,4,3,0.4666666666666667,49.0,53.0
20072008,Radek Bonk,47,38,85,6,3,0.5529411764705883,14.0,35.0
20072008,Chris Drury,89,93,182,10,3,0.489010989010989,43.0,15.0
20072008,Stu Barnes,30,30,60,9,3,0.5,37.0,46.0
20072008,Eric Belanger,52,44,96,6,3,0.5416666666666666,19.0,32.0
20072008,Saku Koivu,84,64,148,7,3,0.5675675675675675,10.0,18.0
20072008,Sidney Crosby,210,219,429,20,3,0.48951048951048953,41.0,2.0
20072008,Maxim Lapierre,59,57,116,12,3,0.5086206896551724,34.0,27.0
20072008,Vladimir Sobotka,22,20,42,6,3,0.5238095238095238,30.0,52.0
20072008,Jarome Iginla,16,25,41,7,3,0.3902439024390244,67.0,55.0
20072008,John Madden,70,61,131,5,3,0.5343511450381679,23.0,21.0
20072008,Jason Spezza,45,33,78,4,3,0.5769230769230769,9.0,36.0
20072008,Brandon Dubinsky,91,95,186,10,3,0.489247311827957,42.0,14.0
20072008,Antoine Vermette,51,39,90,4,3,0.5666666666666667,11.0,33.0
20072008,Joe Sakic,70,69,139,10,3,0.5035971223021583,36.0,21.0
20072008,Vinny Prospal,47,31,78,17,3,0.6025641025641025,5.0,35.0
20072008,Jeff Carter,145,189,334,17,3,0.4341317365269461,57.0,6.0
20072008,Ryan Getzlaf,40,53,93,6,3,0.43010752688172044,59.0,39.0
20072008,Valtteri Filppula,104,94,198,22,3,0.5252525252525253,29.0,12.0
20072008,Tomas Plekanec,115,95,210,12,3,0.5476190476190477,15.0,9.0
20072008,Toby Petersen,43,64,107,16,3,0.40186915887850466,63.0,37.0
20072008,Paul Stastny,54,69,123,9,3,0.43902439024390244,56.0,31.0
20072008,Johan Franzen,21,24,45,16,3,0.4666666666666667,49.0,53.0
20072008,Daniel Cleary,34,33,67,22,3,0.5074626865671642,35.0,43.0
20072008,Rich Peverley,16,21,37,6,3,0.43243243243243246,58.0,55.0
20072008,Joe Thornton,128,115,243,13,3,0.5267489711934157,28.0,7.0
20072008,Brad Richards,123,149,272,18,3,0.4522058823529412,53.0,8.0
20072008,Wayne Primeau,15,15,30,7,3,0.5,37.0,56.0
20072008,Joe Pavelski,83,73,156,13,3,0.532051282051282,26.0,19.0
20072008,Max Talbot,51,68,119,17,3,0.42857142857142855,60.0,33.0
20072008,Sergei Fedorov,77,64,141,7,3,0.5460992907801419,17.0,20.0
20072008,Scott Gomez,85,74,159,10,3,0.5345911949685535,22.0,17.0
20072008,David Legwand,22,27,49,3,3,0.4489795918367347,54.0,52.0
20072008,Steve Ott,42,42,84,18,3,0.5,37.0,38.0
20072008,Pavol Demitra,33,29,62,6,3,0.532258064516129,25.0,44.0
20072008,Vernon Fiddler,37,26,63,6,3,0.5873015873015873,7.0,41.0
20072008,Brooks Laich,33,30,63,7,3,0.5238095238095238,30.0,44.0
20072008,Blair Betts,24,19,43,8,3,0.5581395348837209,12.0,50.0
20072008,Mikko Koivu,58,60,118,6,3,0.4915254237288136,40.0,28.0
20072008,Nicklas Backstrom,43,43,86,7,3,0.5,37.0,37.0
20072008,Mike Ribeiro,112,133,245,18,3,0.45714285714285713,51.0,10.0
20072008,Boyd Gordon,36,40,76,7,3,0.47368421052631576,47.0,42.0
20072008,Evgeni Malkin,83,125,208,20,3,0.39903846153846156,65.0,19.0
20072008,Doug Weight,20,12,32,5,3,0.625,3.0,54.0
20072008,Patrick Marleau,55,40,95,13,3,0.5789473684210527,8.0,30.0
20072008,Travis Zajac,30,14,44,5,3,0.6818181818181818,1.0,46.0
20072008,Jim Dowd,69,55,124,17,3,0.5564516129032258,13.0,22.0
20072008,Chris Higgins,16,32,48,12,3,0.3333333333333333,71.0,55.0
20072008,Mike Modano,106,119,225,18,3,0.4711111111111111,48.0,11.0
20072008,Daniel Bri√®re,102,88,190,17,3,0.5368421052631579,20.0,13.0
20072008,James Sheppard,20,22,42,6,3,0.47619047619047616,46.0,54.0
20072008,Craig Conroy,47,45,92,7,3,0.5108695652173914,33.0,35.0
20072008,Samuel Pahlsson,64,53,117,6,3,0.5470085470085471,16.0,25.0
20072008,Jerred Smithson,26,35,61,6,3,0.4262295081967213,61.0,48.0
20072008,Glen Metropolit,56,60,116,7,3,0.4827586206896552,45.0,29.0
20072008,Bryan Smolinski,88,101,189,12,3,0.4656084656084656,50.0,16.0
20072008,Jason Arnott,23,39,62,4,3,0.3709677419354839,69.0,51.0
20072008,Daymond Langkow,33,50,83,7,3,0.39759036144578314,66.0,44.0
20072008,David Steckel,31,49,80,7,3,0.3875,68.0,45.0
20072008,Tyler Arnason,45,48,93,10,3,0.4838709677419355,44.0,36.0
20072008,Matthew Lombardi,30,31,61,7,3,0.4918032786885246,39.0,46.0
20072008,Patrik Elias,37,44,81,5,3,0.4567901234567901,52.0,41.0
20072008,Stephane Yelle,25,16,41,7,3,0.6097560975609756,4.0,49.0
20072008,Marc Savard,65,58,123,7,3,0.5284552845528455,27.0,24.0
20072008,David Krejci,49,62,111,7,3,0.44144144144144143,55.0,34.0
20072008,Ben Guite,49,50,99,10,3,0.494949494949495,38.0,34.0
20072008,Adam Hall,60,57,117,17,3,0.5128205128205128,32.0,26.0
20072008,Curtis Brown,28,19,47,7,3,0.5957446808510638,6.0,47.0
20072008,Jeremy Roenick,14,21,35,12,3,0.4,64.0,57.0
20072008,Kris Draper,226,124,350,22,3,0.6457142857142857,2.0,1.0
20082009,Brian Rolston,83,97,180,64,2,0.46111111111111114,132.0,144.0
20082009,Petteri Nokelainen,156,136,292,50,2,0.5342465753424658,39.0,122.0
20082009,Jiri Novotny,155,138,293,42,2,0.5290102389078498,47.0,123.0
20082009,Nik Antropov,80,119,199,81,2,0.4020100502512563,166.0,145.0
20082009,Ryan Carter,146,158,304,48,2,0.48026315789473684,118.0,124.0
20082009,Todd White,673,656,1329,82,2,0.5063957863054929,83.0,21.0
20082009,Jordan Staal,567,639,1206,82,2,0.4701492537313433,125.0,36.0
20082009,Mike Richards,813,847,1660,79,2,0.48975903614457833,103.0,6.0
20082009,Henrik Zetterberg,634,555,1189,77,2,0.5332211942809083,40.0,28.0
20082009,Pavel Datsyuk,636,499,1135,81,2,0.560352422907489,20.0,27.0
20082009,Andrew Cogliano,261,441,702,82,2,0.3717948717948718,172.0,94.0
20082009,Paul Gaustad,452,406,858,62,2,0.5268065268065268,53.0,53.0
20082009,Patrik Berglund,215,325,540,76,2,0.39814814814814814,169.0,110.0
20082009,Shawn Horcoff,947,809,1756,80,2,0.5392938496583144,35.0,1.0
20082009,Owen Nolan,75,86,161,59,2,0.4658385093167702,129.0,147.0
20082009,Kyle Brodziak,489,458,947,79,2,0.5163674762407603,69.0,47.0
20082009,Sam Gagner,290,400,690,76,2,0.42028985507246375,161.0,87.0
20082009,Michael Nylander,290,342,632,72,2,0.4588607594936709,135.0,87.0
20082009,Patrice Bergeron,559,466,1025,64,2,0.5453658536585366,28.0,39.0
20082009,Radek Bonk,450,301,751,66,2,0.5992010652463382,5.0,54.0
20082009,Peter Olvecky,63,95,158,31,2,0.3987341772151899,168.0,150.0
20082009,Chris Drury,603,580,1183,81,2,0.5097210481825867,79.0,33.0
20082009,Matt Stajan,605,572,1177,76,2,0.514018691588785,72.0,32.0
20082009,Bryan Little,93,121,214,79,2,0.43457943925233644,154.0,141.0
20082009,Antoine Vermette,642,470,1112,79,2,0.5773381294964028,12.0,26.0
20082009,Pavol Demitra,132,110,242,69,2,0.5454545454545454,27.0,127.0
20082009,Eric Belanger,626,579,1205,79,2,0.5195020746887967,64.0,29.0
20082009,Ian Laperriere,196,250,446,74,2,0.43946188340807174,151.0,116.0
20082009,Martin Hanzal,521,557,1078,74,2,0.48330241187384043,113.0,44.0
20082009,Saku Koivu,607,515,1122,65,2,0.5409982174688057,31.0,31.0
20082009,Sidney Crosby,829,786,1615,77,2,0.513312693498452,73.0,5.0
20082009,Steven Stamkos,253,304,557,79,2,0.4542190305206463,139.0,96.0
20082009,Brett McLean,197,259,456,80,2,0.43201754385964913,156.0,115.0
20082009,Tim Connolly,229,315,544,48,2,0.4209558823529412,160.0,105.0
20082009,Frans Nielsen,358,400,758,59,2,0.47229551451187335,124.0,76.0
20082009,R.J. Umberger,404,437,841,82,2,0.4803804994054697,117.0,66.0
20082009,Samuel Pahlsson,662,575,1237,65,2,0.5351657235246564,38.0,23.0
20082009,Henrik Sedin,677,687,1364,82,2,0.4963343108504399,96.0,20.0
20082009,Ryan Getzlaf,566,562,1128,81,2,0.50177304964539,91.0,37.0
20082009,Richard Park,396,413,809,71,2,0.4894932014833127,104.0,67.0
20082009,Tomas Plekanec,684,667,1351,80,2,0.5062916358253146,84.0,18.0
20082009,Eric Staal,718,868,1586,82,2,0.4527112232030265,142.0,13.0
20082009,Dominic Moore,673,571,1244,81,2,0.5409967845659164,32.0,21.0
20082009,Doug Weight,306,373,679,53,2,0.45066273932253315,144.0,84.0
20082009,Erik Christensen,277,220,497,64,2,0.5573440643863179,22.0,91.0
20082009,Jay McClement,756,695,1451,82,2,0.5210199862164024,60.0,9.0
20082009,Mats Sundin,332,269,601,41,2,0.5524126455906821,24.0,80.0
20082009,Tyler Arnason,332,389,721,71,2,0.4604715672676838,133.0,80.0
20082009,Alexander Steen,107,129,236,81,2,0.4533898305084746,140.0,138.0
20082009,David Backes,212,265,477,82,2,0.4444444444444444,148.0,112.0
20082009,Maxim Lapierre,525,462,987,79,2,0.5319148936170213,42.0,42.0
20082009,Dustin Boyd,217,260,477,71,2,0.4549266247379455,137.0,108.0
20082009,Vincent Lecavalier,710,685,1395,77,2,0.5089605734767025,81.0,15.0
20082009,Jarome Iginla,263,238,501,82,2,0.5249500998003992,55.0,93.0
20082009,Andy Hilbert,71,115,186,67,2,0.3817204301075269,171.0,149.0
20082009,Andrew Ebbett,221,234,455,48,2,0.4857142857142857,109.0,107.0
20082009,Brandon Dubinsky,466,404,870,82,2,0.535632183908046,37.0,50.0
20082009,Jeff Carter,833,892,1725,82,2,0.48289855072463767,115.0,4.0
20082009,Valtteri Filppula,409,376,785,80,2,0.5210191082802548,61.0,65.0
20082009,Toby Petersen,128,155,283,57,2,0.45229681978798586,143.0,129.0
20082009,Michael Peca,417,422,839,71,2,0.4970202622169249,95.0,61.0
20082009,Johan Franzen,135,106,241,71,2,0.5601659751037344,21.0,125.0
20082009,Robert Lang,375,393,768,50,2,0.48828125,105.0,72.0
20082009,Steve Ott,80,92,172,64,2,0.46511627906976744,130.0,145.0
20082009,Lauri Korpikoski,88,132,220,68,2,0.4,167.0,143.0
20082009,John Madden,599,561,1160,76,2,0.5163793103448275,68.0,34.0
20082009,Dean McAmmond,242,301,543,62,2,0.44567219152854515,146.0,101.0
20082009,Glen Metropolit,382,395,777,76,2,0.49163449163449163,101.0,68.0
20082009,John Mitchell,326,343,669,76,2,0.4872944693572496,106.0,82.0
20082009,Paul Szczechura,94,138,232,31,2,0.4051724137931034,165.0,140.0
20082009,T.J. Hensick,241,269,510,61,2,0.4725490196078431,122.0,102.0
20082009,Derek Armstrong,115,125,240,56,2,0.4791666666666667,119.0,132.0
20082009,Benoit Pouliot,93,124,217,37,2,0.42857142857142855,157.0,141.0
20082009,Jamal Mayers,246,183,429,71,2,0.5734265734265734,14.0,98.0
20082009,Todd Marchant,298,295,593,72,2,0.5025295109612141,90.0,86.0
20082009,Kris Versteeg,124,142,266,78,2,0.46616541353383456,128.0,130.0
20082009,Joe Thornton,718,577,1295,82,2,0.5544401544401545,23.0,13.0
20082009,Vinny Prospal,107,95,202,82,2,0.5297029702970297,46.0,138.0
20082009,Clarke MacArthur,76,142,218,71,2,0.3486238532110092,173.0,146.0
20082009,Manny Malhotra,801,579,1380,77,2,0.5804347826086956,9.0,7.0
20082009,Tomas Plihal,131,117,248,64,2,0.5282258064516129,49.0,128.0
20082009,Jussi Jokinen,361,312,673,71,2,0.5364041604754829,36.0,75.0
20082009,Colin Fraser,376,411,787,81,2,0.4777636594663278,120.0,71.0
20082009,Shane Doan,160,202,362,82,2,0.4419889502762431,150.0,120.0
20082009,Scott Nichol,196,163,359,43,2,0.5459610027855153,26.0,116.0
20082009,Boyd Gordon,374,293,667,63,2,0.56071964017991,19.0,73.0
20082009,Evgeni Malkin,283,385,668,82,2,0.4236526946107784,159.0,90.0
20082009,Mike Zigomanis,158,93,251,22,2,0.6294820717131474,1.0,121.0
20082009,Jeff Halpern,434,388,822,52,2,0.5279805352798054,51.0,59.0
20082009,Brad Richards,461,450,911,56,2,0.5060373216245884,86.0,51.0
20082009,Anze Kopitar,671,684,1355,82,2,0.4952029520295203,98.0,22.0
20082009,Jarret Stoll,599,448,1047,74,2,0.5721107927411653,15.0,34.0
20082009,Jesse Winchester,113,86,199,76,2,0.5678391959798995,16.0,133.0
20082009,Jochen Hecht,235,303,538,70,2,0.4368029739776952,153.0,103.0
20082009,Mike Fisher,535,509,1044,78,2,0.5124521072796935,75.0,40.0
20082009,Jason Spezza,787,690,1477,82,2,0.5328368314150305,41.0,8.0
20082009,Joe Sakic,117,99,216,15,2,0.5416666666666666,30.0,131.0
20082009,Darroll Powe,128,135,263,60,2,0.4866920152091255,108.0,129.0
20082009,Marc-Antoine Pouliot,102,109,211,63,2,0.4834123222748815,112.0,139.0
20082009,Marcel Goc,332,238,570,55,2,0.5824561403508772,8.0,80.0
20082009,Paul Stastny,440,410,850,45,2,0.5176470588235295,65.0,55.0
20082009,Mike Comrie,171,246,417,63,2,0.41007194244604317,164.0,117.0
20082009,Kris Versteeg,124,142,266,78,2,0.46616541353383456,128.0,130.0
20082009,Joe Thornton,718,577,1295,82,2,0.5544401544401545,23.0,13.0
20082009,James Sheppard,361,509,870,82,2,0.4149425287356322,162.0,75.0
20082009,Mikhail Grabovski,426,531,957,78,2,0.445141065830721,147.0,60.0
20082009,Adam Mair,200,214,414,75,2,0.4830917874396135,114.0,114.0
20082009,Ryan Kesler,527,449,976,82,2,0.5399590163934426,34.0,41.0
20082009,Vernon Fiddler,331,281,612,78,2,0.5408496732026143,33.0,81.0
20082009,Matt Cullen,457,427,884,69,2,0.5169683257918553,67.0,52.0
20082009,Ryan Johnson,274,291,565,62,2,0.4849557522123894,110.0,92.0
20082009,Olli Jokinen,413,539,952,76,2,0.4338235294117647,155.0,62.0
20082009,Andy McDonald,213,154,367,46,2,0.5803814713896458,10.0,111.0
20082009,Wayne Primeau,115,102,217,24,2,0.5299539170506913,45.0,132.0
20082009,Joe Pavelski,717,557,1274,80,2,0.5627943485086342,17.0,14.0
20082009,Marty Reasoner,603,538,1141,79,2,0.5284837861524978,48.0,33.0
20082009,Craig Conroy,730,652,1382,82,2,0.5282199710564399,50.0,11.0
20082009,Keith Tkachuk,472,446,918,79,2,0.514161220043573,71.0,49.0
20082009,Claude Giroux,146,163,309,42,2,0.47249190938511326,123.0,124.0
20082009,Kyle Turris,243,324,567,63,2,0.42857142857142855,157.0,100.0
20082009,Dave Bolland,522,655,1177,81,2,0.443500424808836,149.0,43.0
20082009,Bobby Holik,300,206,506,62,2,0.5928853754940712,6.0,85.0
20082009,Patrick Marleau,310,281,591,76,2,0.5245346869712352,57.0,83.0
20082009,Michael Cammalleri,222,146,368,81,2,0.6032608695652174,3.0,106.0
20082009,Kyle Wellwood,357,264,621,74,2,0.5748792270531401,13.0,77.0
20082009,Nathan Horton,377,486,863,67,2,0.43684820393974505,152.0,70.0
20082009,Matthew Lombardi,438,405,843,69,2,0.5195729537366548,63.0,57.0
20082009,Max Talbot,277,265,542,75,2,0.511070110701107,77.0,91.0
20082009,Eric Perrin,111,102,213,78,2,0.5211267605633803,59.0,135.0
20082009,Jason Williams,284,334,618,80,2,0.459546925566343,134.0,89.0
20082009,Teemu Selanne,110,114,224,65,2,0.49107142857142855,102.0,136.0
20082009,Brooks Laich,261,250,511,82,2,0.5107632093933464,78.0,94.0
20082009,Chris Gratton,134,95,229,24,2,0.5851528384279476,7.0,126.0
20082009,Jonathan Toews,704,583,1287,82,2,0.5470085470085471,25.0,16.0
20082009,Brandon Sutter,128,204,332,50,2,0.3855421686746988,170.0,129.0
20082009,Brendan Morrison,204,246,450,81,2,0.4533333333333333,141.0,113.0
20082009,Jim Slater,245,217,462,60,2,0.5303030303030303,44.0,99.0
20082009,Travis Zajac,683,604,1287,82,2,0.5306915306915307,43.0,19.0
20082009,David Krejci,527,521,1048,82,2,0.5028625954198473,89.0,41.0
20082009,Marc Savard,643,646,1289,82,2,0.49883630721489525,93.0,25.0
20082009,Derick Brassard,161,171,332,31,2,0.48493975903614456,111.0,119.0
20082009,Jerred Smithson,380,342,722,82,2,0.5263157894736842,54.0,69.0
20082009,Josh Bailey,332,475,807,68,2,0.4114002478314746,163.0,80.0
20082009,Wojtek Wolski,248,267,515,78,2,0.4815533980582524,116.0,97.0
20082009,Brian Sutherby,112,152,264,59,2,0.42424242424242425,158.0,134.0
20082009,Dainius Zubrus,473,450,923,82,2,0.5124593716143012,74.0,48.0
20082009,Sergei Fedorov,368,287,655,52,2,0.5618320610687023,18.0,74.0
20082009,Blair Betts,436,448,884,81,2,0.49321266968325794,99.0,58.0
20082009,Gregory Campbell,509,509,1018,77,2,0.5,92.0,46.0
20082009,Mikko Koivu,857,768,1625,79,2,0.5273846153846153,52.0,3.0
20082009,Nicklas Backstrom,570,601,1171,82,2,0.48676345004269855,107.0,35.0
20082009,Ryan Smyth,89,85,174,77,2,0.5114942528735632,76.0,142.0
20082009,Jason Arnott,525,512,1037,65,2,0.506268081002893,85.0,42.0
20082009,Daymond Langkow,353,400,753,73,2,0.46879150066401065,127.0,79.0
20082009,Stephen Weiss,650,627,1277,78,2,0.5090054815974941,80.0,24.0
20082009,David Steckel,513,373,886,76,2,0.5790067720090294,11.0,45.0
20082009,Patrick Sharp,259,307,566,61,2,0.4575971731448763,136.0,95.0
20082009,Adam Hall,169,169,338,74,2,0.5,92.0,118.0
20082009,Kamil Kreps,439,431,870,66,2,0.5045977011494253,87.0,56.0
20082009,Milan Hejduk,72,88,160,82,2,0.45,145.0,148.0
20082009,Scott Gomez,687,625,1312,77,2,0.5236280487804879,58.0,17.0
20082009,David Legwand,509,514,1023,73,2,0.4975562072336266,94.0,46.0
20082009,Stephane Yelle,412,380,792,77,2,0.5202020202020202,62.0,63.0
20082009,Steve Reinprecht,410,476,886,73,2,0.46275395033860045,131.0,64.0
20082009,Ben Guite,286,269,555,50,2,0.5153153153153153,70.0,88.0
20082009,Rod Brind'Amour,908,580,1488,80,2,0.6102150537634409,2.0,2.0
20082009,Michal Handzus,719,601,1320,82,2,0.5446969696969697,29.0,12.0
20082009,Chris Kelly,234,260,494,82,2,0.47368421052631576,121.0,104.0
20082009,Ryan Craig,110,112,222,54,2,0.4954954954954955,97.0,136.0
20082009,Mike Ribeiro,564,676,1240,82,2,0.45483870967741935,138.0,38.0
20082009,Nate Thompson,216,213,429,43,2,0.5034965034965035,88.0,109.0
20082009,Mike Modano,617,559,1176,80,2,0.5246598639455783,56.0,30.0
20082009,Rich Peverley,354,330,684,66,2,0.5175438596491229,66.0,78.0
20082009,Brad Boyes,155,160,315,82,2,0.49206349206349204,100.0,123.0
20082009,Jeremy Roenick,109,123,232,42,2,0.4698275862068966,126.0,137.0
20082009,Kris Draper,603,397,1000,79,2,0.603,4.0,33.0
20082009,Derek Roy,745,724,1469,82,2,0.5071477195371,82.0,10.0
20082009,Brian Rolston,13,18,31,7,3,0.41935483870967744,60.0,56.0
20082009,Ryan Carter,17,18,35,10,3,0.4857142857142857,41.0,53.0
20082009,Jordan Staal,167,195,362,24,3,0.4613259668508287,49.0,3.0
20082009,Mike Richards,55,70,125,6,3,0.44,57.0,30.0
20082009,Henrik Zetterberg,251,193,444,23,3,0.5653153153153153,11.0,2.0
20082009,Torrey Mitchell,16,15,31,4,3,0.5161290322580645,32.0,54.0
20082009,Pavel Datsyuk,116,98,214,16,3,0.5420560747663551,17.0,12.0
20082009,Darren Helm,107,100,207,23,3,0.5169082125603864,30.0,15.0
20082009,Tyler Kennedy,15,19,34,24,3,0.4411764705882353,55.0,55.0
20082009,Patrice Bergeron,104,86,190,11,3,0.5473684210526316,14.0,17.0
20082009,Chris Drury,23,19,42,6,3,0.5476190476190477,13.0,49.0
20082009,Saku Koivu,34,32,66,4,3,0.5151515151515151,33.0,43.0
20082009,Sidney Crosby,281,249,530,24,3,0.530188679245283,22.0,1.0
20082009,Maxim Lapierre,23,27,50,4,3,0.46,50.0,49.0
20082009,Jussi Jokinen,88,76,164,18,3,0.5365853658536586,19.0,20.0
20082009,Jarome Iginla,22,16,38,6,3,0.5789473684210527,9.0,50.0
20082009,John Madden,74,63,137,7,3,0.5401459854014599,18.0,24.0
20082009,Manny Malhotra,43,31,74,4,3,0.581081081081081,8.0,37.0
20082009,Andrew Ebbett,35,59,94,13,3,0.3723404255319149,65.0,42.0
20082009,Brandon Dubinsky,58,58,116,7,3,0.5,35.0,29.0
20082009,Justin Abdelkader,17,22,39,10,3,0.4358974358974359,58.0,53.0
20082009,Craig Adams,43,49,92,24,3,0.4673913043478261,46.0,37.0
20082009,Jeff Carter,54,75,129,6,3,0.4186046511627907,61.0,31.0
20082009,Ryan Getzlaf,118,135,253,13,3,0.466403162055336,47.0,11.0
20082009,Henrik Sedin,93,87,180,10,3,0.5166666666666667,31.0,19.0
20082009,Valtteri Filppula,132,126,258,23,3,0.5116279069767442,34.0,8.0
20082009,Tomas Plekanec,30,15,45,3,3,0.6666666666666666,1.0,44.0
20082009,Marcel Goc,18,18,36,6,3,0.5,35.0,52.0
20082009,Michael Peca,17,18,35,4,3,0.4857142857142857,41.0,53.0
20082009,Eric Staal,150,195,345,18,3,0.43478260869565216,59.0,4.0
20082009,Petteri Nokelainen,23,49,72,9,3,0.3194444444444444,68.0,49.0
20082009,Johan Franzen,26,19,45,23,3,0.5777777777777777,10.0,47.0
20082009,Antoine Vermette,34,43,77,4,3,0.44155844155844154,54.0,43.0
20082009,Todd Marchant,133,112,245,13,3,0.5428571428571428,16.0,7.0
20082009,Ryan Kesler,46,41,87,10,3,0.5287356321839081,23.0,36.0
20082009,Ryan Johnson,68,48,116,10,3,0.5862068965517241,6.0,25.0
20082009,Matt Cullen,130,135,265,18,3,0.49056603773584906,38.0,9.0
20082009,Marc Savard,96,89,185,11,3,0.518918918918919,28.0,18.0
20082009,David Krejci,63,65,128,11,3,0.4921875,36.0,26.0
20082009,Scott Gomez,59,68,127,7,3,0.4645669291338583,48.0,28.0
20082009,Stephane Yelle,60,54,114,11,3,0.5263157894736842,25.0,27.0
20082009,Evgeni Malkin,83,93,176,24,3,0.4715909090909091,43.0,21.0
20082009,Boyd Gordon,76,44,120,14,3,0.6333333333333333,2.0,23.0
20082009,Joe Pavelski,40,45,85,6,3,0.47058823529411764,44.0,39.0
20082009,Max Talbot,80,100,180,24,3,0.4444444444444444,52.0,22.0
20082009,Olli Jokinen,38,40,78,6,3,0.48717948717948717,40.0,40.0
20082009,Blair Betts,35,49,84,6,3,0.4166666666666667,62.0,42.0
20082009,Nicklas Backstrom,106,110,216,14,3,0.49074074074074076,37.0,16.0
20082009,Jason Williams,15,15,30,4,3,0.5,35.0,55.0
20082009,David Backes,22,34,56,4,3,0.39285714285714285,64.0,50.0
20082009,Patrick Marleau,28,26,54,6,3,0.5185185185185185,29.0,45.0
20082009,Kyle Wellwood,47,53,100,10,3,0.47,45.0,35.0
20082009,Teemu Selanne,12,18,30,13,3,0.4,63.0,57.0
20082009,Jonathan Toews,146,100,246,17,3,0.5934959349593496,5.0,5.0
20082009,Adam Burish,50,75,125,17,3,0.4,63.0,33.0
20082009,Brooks Laich,30,20,50,14,3,0.6,3.0,44.0
20082009,Rod Brind'Amour,127,117,244,18,3,0.5204918032786885,27.0,10.0
20082009,Mats Sundin,52,46,98,8,3,0.5306122448979592,21.0,32.0
20082009,Jay McClement,42,38,80,4,3,0.525,26.0,38.0
20082009,Samuel Pahlsson,108,97,205,17,3,0.526829268292683,24.0,14.0
20082009,Travis Zajac,49,51,100,7,3,0.49,39.0,34.0
20082009,Sergei Fedorov,111,96,207,14,3,0.5362318840579711,20.0,13.0
20082009,Dainius Zubrus,35,29,64,7,3,0.546875,15.0,42.0
20082009,Kris Draper,43,29,72,8,3,0.5972222222222222,4.0,37.0
20082009,Joe Thornton,52,42,94,6,3,0.5531914893617021,12.0,32.0
20082009,Kris Versteeg,21,37,58,17,3,0.3620689655172414,66.0,51.0
20082009,Keith Tkachuk,37,47,84,4,3,0.44047619047619047,56.0,41.0
20082009,Claude Giroux,27,34,61,6,3,0.4426229508196721,53.0,46.0
20082009,Dave Bolland,139,165,304,17,3,0.45723684210526316,51.0,6.0
20082009,Craig Conroy,38,41,79,6,3,0.4810126582278481,42.0,40.0
20082009,Daymond Langkow,21,41,62,6,3,0.3387096774193548,67.0,51.0
20082009,David Steckel,108,77,185,14,3,0.5837837837837838,7.0,14.0
20082009,Glen Metropolit,24,36,60,4,3,0.4,63.0,48.0
20092010,Patrick Dwyer,78,146,224,58,2,0.3482142857142857,169.0,143.0
20092010,Matthew Lombardi,452,458,910,78,2,0.4967032967032967,88.0,65.0
20092010,Zack Stortini,87,96,183,77,2,0.47540983606557374,115.0,142.0
20092010,Ryan Carter,116,105,221,38,2,0.5248868778280543,44.0,133.0
20092010,Todd White,401,344,745,65,2,0.538255033557047,33.0,71.0
20092010,Eric Nystrom,127,152,279,82,2,0.4551971326164875,132.0,130.0
20092010,Jordan Staal,639,685,1324,82,2,0.4826283987915408,108.0,23.0
20092010,Zenon Konopka,288,174,462,74,2,0.6233766233766234,2.0,91.0
20092010,Mike Richards,696,677,1373,82,2,0.5069191551347414,76.0,14.0
20092010,Ryan O'Reilly,485,529,1014,81,2,0.47830374753451677,111.0,55.0
20092010,Henrik Zetterberg,544,554,1098,74,2,0.49544626593806923,91.0,40.0
20092010,Torrey Mitchell,89,116,205,56,2,0.43414634146341463,156.0,141.0
20092010,Rod Pelley,98,100,198,63,2,0.494949494949495,94.0,138.0
20092010,Pavel Datsyuk,590,480,1070,80,2,0.5514018691588785,23.0,32.0
20092010,Darren Helm,447,428,875,75,2,0.5108571428571429,69.0,66.0
20092010,Andrew Cogliano,163,216,379,82,2,0.43007915567282323,159.0,120.0
20092010,Paul Gaustad,599,444,1043,65,2,0.5743048897411314,10.0,31.0
20092010,Patrik Berglund,220,284,504,71,2,0.4365079365079365,154.0,102.0
20092010,Clarke MacArthur,67,86,153,81,2,0.43790849673202614,152.0,150.0
20092010,Shawn Horcoff,621,716,1337,77,2,0.4644727000747943,124.0,26.0
20092010,Patrice Bergeron,778,564,1342,73,2,0.5797317436661699,8.0,7.0
20092010,Owen Nolan,184,206,390,73,2,0.4717948717948718,120.0,115.0
20092010,Andrew Ebbett,274,279,553,61,2,0.49547920433996384,90.0,94.0
20092010,Sam Gagner,336,373,709,68,2,0.47390691114245415,118.0,81.0
20092010,Chris Drury,638,568,1206,77,2,0.5290215588723052,38.0,24.0
20092010,Bryan Little,68,86,154,79,2,0.44155844155844154,149.0,149.0
20092010,Martin Hanzal,559,545,1104,81,2,0.5063405797101449,77.0,39.0
20092010,Sidney Crosby,1001,790,1791,81,2,0.5589056393076494,18.0,1.0
20092010,Matt Duchene,479,609,1088,81,2,0.44025735294117646,151.0,59.0
20092010,Erik Christensen,329,345,674,58,2,0.48813056379821956,102.0,82.0
20092010,Steven Stamkos,481,523,1004,82,2,0.47908366533864544,109.0,57.0
20092010,Tim Connolly,358,406,764,73,2,0.468586387434555,122.0,79.0
20092010,Scott Nichol,504,328,832,79,2,0.6057692307692307,3.0,48.0
20092010,Frans Nielsen,583,582,1165,76,2,0.5004291845493563,83.0,35.0
20092010,Rob Schremp,187,208,395,44,2,0.47341772151898737,119.0,113.0
20092010,Olli Jokinen,480,493,973,82,2,0.4933196300102775,97.0,58.0
20092010,Jarret Stoll,619,486,1105,73,2,0.5601809954751131,16.0,27.0
20092010,Jochen Hecht,146,176,322,79,2,0.453416149068323,135.0,124.0
20092010,Mike Fisher,679,628,1307,79,2,0.5195103289977047,51.0,18.0
20092010,Jason Spezza,514,504,1018,60,2,0.5049115913555993,79.0,46.0
20092010,Tyler Bozak,358,290,648,37,2,0.5524691358024691,22.0,79.0
20092010,Valtteri Filppula,296,277,573,55,2,0.5165794066317626,55.0,89.0
20092010,Brian Boyle,125,198,323,71,2,0.38699690402476783,166.0,131.0
20092010,Colin Fraser,217,228,445,70,2,0.48764044943820223,104.0,103.0
20092010,Eric Staal,486,676,1162,70,2,0.41824440619621345,162.0,54.0
20092010,Matt Cullen,572,549,1121,81,2,0.5102586975914363,70.0,36.0
20092010,Mika Pyorala,95,112,207,36,2,0.45893719806763283,128.0,139.0
20092010,Manny Malhotra,415,249,664,71,2,0.625,1.0,69.0
20092010,TJ Galiardi,165,162,327,70,2,0.5045871559633027,80.0,119.0
20092010,Matt Stajan,690,644,1334,82,2,0.5172413793103449,53.0,16.0
20092010,Adam Mair,93,85,178,69,2,0.5224719101123596,48.0,140.0
20092010,Maxim Lapierre,208,217,425,76,2,0.4894117647058824,100.0,107.0
20092010,Shawn Matthias,119,194,313,55,2,0.3801916932907348,167.0,132.0
20092010,Nate Thompson,323,272,595,71,2,0.5428571428571428,28.0,84.0
20092010,Brandon Dubinsky,347,328,675,69,2,0.5140740740740741,62.0,80.0
20092010,Ryan Getzlaf,533,591,1124,66,2,0.47419928825622776,117.0,43.0
20092010,Henrik Sedin,756,771,1527,82,2,0.4950884086444008,92.0,10.0
20092010,Marc-Antoine Pouliot,104,131,235,35,2,0.4425531914893617,148.0,135.0
20092010,Kyle Brodziak,484,517,1001,82,2,0.4835164835164835,107.0,56.0
20092010,John Madden,613,543,1156,79,2,0.5302768166089965,37.0,29.0
20092010,Antoine Vermette,852,721,1573,82,2,0.5416401780038144,30.0,3.0
20092010,Eric Belanger,521,403,924,77,2,0.5638528138528138,15.0,45.0
20092010,Joe Thornton,662,566,1228,79,2,0.5390879478827362,32.0,21.0
20092010,Kris Versteeg,77,106,183,79,2,0.4207650273224044,160.0,144.0
20092010,Anze Kopitar,602,609,1211,82,2,0.49710982658959535,87.0,30.0
20092010,Brad Richards,587,553,1140,80,2,0.5149122807017544,60.0,34.0
20092010,Jussi Jokinen,136,129,265,81,2,0.5132075471698113,64.0,128.0
20092010,Vladimir Sobotka,196,165,361,61,2,0.5429362880886427,27.0,111.0
20092010,R.J. Umberger,372,332,704,82,2,0.5284090909090909,41.0,77.0
20092010,Darroll Powe,95,115,210,63,2,0.4523809523809524,136.0,139.0
20092010,Petr Prucha,68,83,151,79,2,0.4503311258278146,140.0,149.0
20092010,Dominic Moore,365,298,663,69,2,0.55052790346908,25.0,78.0
20092010,Gilbert Brule,144,130,274,65,2,0.5255474452554745,43.0,125.0
20092010,Richard Park,536,504,1040,81,2,0.5153846153846153,58.0,42.0
20092010,Tomas Plekanec,791,824,1615,82,2,0.48978328173374613,99.0,6.0
20092010,Shane Doan,70,83,153,82,2,0.45751633986928103,129.0,147.0
20092010,Robert Lang,375,359,734,64,2,0.510899182561308,68.0,76.0
20092010,Jay McClement,701,711,1412,82,2,0.4964589235127479,89.0,12.0
20092010,Patrik Elias,205,252,457,58,2,0.4485776805251641,142.0,108.0
20092010,Jesse Winchester,209,168,377,52,2,0.5543766578249337,19.0,106.0
20092010,Artem Anisimov,310,380,690,82,2,0.4492753623188406,141.0,86.0
20092010,Vincent Lecavalier,771,678,1449,82,2,0.5320910973084886,36.0,9.0
20092010,Jarome Iginla,152,171,323,82,2,0.47058823529411764,121.0,122.0
20092010,Jeff Halpern,294,276,570,71,2,0.5157894736842106,57.0,90.0
20092010,Paul Szczechura,186,217,403,52,2,0.46153846153846156,127.0,114.0
20092010,Craig Adams,246,316,562,82,2,0.4377224199288256,153.0,97.0
20092010,Jeff Carter,688,626,1314,74,2,0.5235920852359208,47.0,17.0
20092010,Toby Petersen,76,95,171,78,2,0.4444444444444444,146.0,145.0
20092010,Trent Whitfield,103,75,178,16,2,0.5786516853932584,9.0,136.0
20092010,Todd Marchant,284,285,569,78,2,0.4991212653778559,86.0,92.0
20092010,Doug Weight,69,83,152,36,2,0.45394736842105265,134.0,148.0
20092010,Matt Ellis,141,141,282,72,2,0.5,84.0,126.0
20092010,Rickard Wallin,225,281,506,60,2,0.44466403162055335,145.0,101.0
20092010,Steve Ott,200,152,352,73,2,0.5681818181818182,13.0,110.0
20092010,Mikael Backlund,102,89,191,23,2,0.5340314136125655,35.0,137.0
20092010,Dustin Boyd,244,229,473,78,2,0.5158562367864693,56.0,98.0
20092010,John Mitchell,244,233,477,60,2,0.5115303983228512,67.0,98.0
20092010,Justin Abdelkader,148,170,318,50,2,0.46540880503144655,123.0,123.0
20092010,Kyle Chipchura,378,398,776,74,2,0.48711340206185566,105.0,75.0
20092010,Tim Kennedy,133,264,397,78,2,0.3350125944584383,170.0,129.0
20092010,Dustin Boyd,244,229,473,78,2,0.5158562367864693,56.0,98.0
20092010,Brandon Dubinsky,347,328,675,69,2,0.5140740740740741,62.0,80.0
20092010,Ryan Getzlaf,533,591,1124,66,2,0.47419928825622776,117.0,43.0
20092010,Henrik Sedin,756,771,1527,82,2,0.4950884086444008,92.0,10.0
20092010,Marc-Antoine Pouliot,104,131,235,35,2,0.4425531914893617,148.0,135.0
20092010,Kyle Brodziak,484,517,1001,82,2,0.4835164835164835,107.0,56.0
20092010,Shane Doan,70,83,153,82,2,0.45751633986928103,129.0,147.0
20092010,Robert Lang,375,359,734,64,2,0.510899182561308,68.0,76.0
20092010,Manny Malhotra,415,249,664,71,2,0.625,1.0,69.0
20092010,TJ Galiardi,165,162,327,70,2,0.5045871559633027,80.0,119.0
20092010,Matt Stajan,690,644,1334,82,2,0.5172413793103449,53.0,16.0
20092010,Adam Mair,93,85,178,69,2,0.5224719101123596,48.0,140.0
20092010,Scott Gomez,698,677,1375,78,2,0.5076363636363637,74.0,13.0
20092010,Blair Betts,435,420,855,63,2,0.5087719298245614,73.0,67.0
20092010,Ryan Kesler,772,629,1401,82,2,0.5510349750178444,24.0,8.0
20092010,Jamal Mayers,214,165,379,71,2,0.5646437994722955,14.0,104.0
20092010,Steve Reinprecht,472,517,989,82,2,0.47724974721941354,113.0,63.0
20092010,Ryan Johnson,283,254,537,58,2,0.527001862197393,42.0,93.0
20092010,Dustin Penner,201,220,421,82,2,0.47743467933491684,112.0,109.0
20092010,Andy McDonald,241,206,447,79,2,0.5391498881431768,31.0,99.0
20092010,Joe Pavelski,477,344,821,67,2,0.5809987819732034,7.0,61.0
20092010,Marty Reasoner,512,494,1006,80,2,0.5089463220675944,72.0,47.0
20092010,Craig Conroy,453,426,879,63,2,0.515358361774744,59.0,64.0
20092010,Keith Tkachuk,389,306,695,67,2,0.5597122302158274,17.0,73.0
20092010,Claude Giroux,297,303,600,82,2,0.495,93.0,88.0
20092010,Dave Bolland,274,281,555,39,2,0.4936936936936937,96.0,94.0
20092010,Martin St. Louis,71,86,157,82,2,0.45222929936305734,137.0,146.0
20092010,Patrick Marleau,316,299,615,82,2,0.5138211382113821,63.0,85.0
20092010,Kyle Wellwood,390,335,725,75,2,0.5379310344827586,34.0,72.0
20092010,Petteri Nokelainen,200,244,444,67,2,0.45045045045045046,139.0,110.0
20092010,Max Talbot,68,97,165,45,2,0.4121212121212121,164.0,149.0
20092010,Brandon Sutter,489,508,997,72,2,0.49047141424272817,98.0,53.0
20092010,Brooks Laich,152,185,337,78,2,0.45103857566765576,138.0,122.0
20092010,Jonathan Toews,801,596,1397,76,2,0.5733715103793844,11.0,5.0
20092010,Ryan Potulny,389,431,820,64,2,0.474390243902439,116.0,73.0
20092010,Jim Slater,254,177,431,61,2,0.5893271461716937,5.0,95.0
20092010,Brendan Morrison,501,477,978,74,2,0.5122699386503068,65.0,49.0
20092010,Wayne Primeau,283,229,512,59,2,0.552734375,21.0,93.0
20092010,Tom Wandell,214,272,486,50,2,0.4403292181069959,150.0,104.0
20092010,Travis Zajac,726,647,1373,82,2,0.5287691187181355,39.0,11.0
20092010,Nik Antropov,481,627,1108,76,2,0.434115523465704,157.0,57.0
20092010,Stephane Yelle,181,199,380,70,2,0.4763157894736842,114.0,116.0
20092010,David Krejci,560,544,1104,79,2,0.5072463768115942,75.0,38.0
20092010,Marc Savard,316,332,648,41,2,0.4876543209876543,103.0,85.0
20092010,Derick Brassard,210,293,503,79,2,0.41749502982107356,163.0,105.0
20092010,Jerred Smithson,301,247,548,69,2,0.5492700729927007,26.0,87.0
20092010,Vinny Prospal,327,312,639,75,2,0.5117370892018779,66.0,83.0
20092010,Josh Bailey,171,255,426,73,2,0.4014084507042254,165.0,117.0
20092010,Dainius Zubrus,194,206,400,51,2,0.485,106.0,112.0
20092010,Christian Hanson,98,79,177,31,2,0.5536723163841808,20.0,138.0
20092010,Gregory Campbell,158,183,341,60,2,0.4633431085043988,125.0,121.0
20092010,Mikko Koivu,864,654,1518,80,2,0.5691699604743083,12.0,2.0
20092010,Nicklas Backstrom,667,669,1336,82,2,0.49925149700598803,85.0,20.0
20092010,Patrick O'Sullivan,71,124,195,73,2,0.3641025641025641,168.0,146.0
20092010,Jason Arnott,526,551,1077,63,2,0.4883936861652739,101.0,44.0
20092010,Daymond Langkow,492,638,1130,72,2,0.4353982300884956,155.0,52.0
20092010,Stephen Weiss,813,738,1551,80,2,0.5241779497098646,46.0,4.0
20092010,David Steckel,637,439,1076,79,2,0.5920074349442379,4.0,25.0
20092010,Samuel Pahlsson,673,600,1273,79,2,0.5286724273369993,40.0,19.0
20092010,Dean McAmmond,253,303,556,62,2,0.4550359712230216,133.0,96.0
20092010,Patrick Sharp,241,225,466,82,2,0.5171673819742489,54.0,99.0
20092010,Kamil Kreps,382,355,737,76,2,0.5183175033921302,52.0,74.0
20092010,Vernon Fiddler,588,533,1121,76,2,0.5245316681534344,45.0,33.0
20092010,David Legwand,538,586,1124,82,2,0.4786476868327402,110.0,41.0
20092010,Saku Koivu,571,539,1110,71,2,0.5144144144144144,61.0,37.0
20092010,Rod Brind'Amour,499,350,849,80,2,0.5877502944640753,6.0,50.0
20092010,Michal Handzus,694,669,1363,81,2,0.5091709464416728,71.0,15.0
20092010,Peter Regin,240,298,538,75,2,0.44609665427509293,144.0,100.0
20092010,Chris Kelly,408,486,894,81,2,0.4563758389261745,130.0,70.0
20092010,Jamie Benn,109,127,236,82,2,0.461864406779661,126.0,134.0
20092010,Rich Peverley,647,546,1193,82,2,0.5423302598491199,29.0,22.0
20092010,T.J. Oshie,64,89,153,76,2,0.41830065359477125,161.0,152.0
20092010,Mike Ribeiro,494,608,1102,66,2,0.4482758620689655,143.0,51.0
20092010,Glen Metropolit,327,334,661,69,2,0.4947049924357035,95.0,83.0
20092010,James Wright,77,92,169,48,2,0.4556213017751479,131.0,144.0
20092010,Rob Niedermayer,478,467,945,71,2,0.5058201058201058,78.0,60.0
20092010,Rick Rypien,66,87,153,69,2,0.43137254901960786,158.0,151.0
20092010,Mike Modano,427,420,847,59,2,0.5041322314049587,81.0,68.0
20092010,Brad Boyes,138,173,311,82,2,0.4437299035369775,147.0,127.0
20092010,Marcel Goc,475,437,912,73,2,0.5208333333333334,49.0,62.0
20092010,Kris Draper,166,153,319,81,2,0.5203761755485894,50.0,118.0
20092010,Derek Roy,617,608,1225,80,2,0.5036734693877551,82.0,28.0
20092010,Matthew Lombardi,51,51,102,7,3,0.5,36.0,31.0
20092010,Jordan Staal,78,85,163,11,3,0.4785276073619632,42.0,19.0
20092010,Mike Richards,216,240,456,23,3,0.47368421052631576,45.0,2.0
20092010,Ryane Clowe,11,27,38,15,3,0.2894736842105263,71.0,58.0
20092010,Ryan O'Reilly,25,31,56,6,3,0.44642857142857145,53.0,50.0
20092010,Henrik Zetterberg,87,105,192,12,3,0.453125,51.0,17.0
20092010,Pavel Datsyuk,129,114,243,12,3,0.5308641975308642,22.0,9.0
20092010,Darren Helm,88,84,172,12,3,0.5116279069767442,30.0,16.0
20092010,Paul Gaustad,49,51,100,6,3,0.49,40.0,33.0
20092010,Patrice Bergeron,169,123,292,13,3,0.5787671232876712,9.0,5.0
20092010,Martin Hanzal,74,60,134,7,3,0.5522388059701493,15.0,21.0
20092010,Pavol Demitra,16,23,39,11,3,0.41025641025641024,62.0,54.0
20092010,Sidney Crosby,155,122,277,13,3,0.5595667870036101,13.0,6.0
20092010,Matt Duchene,29,51,80,6,3,0.3625,68.0,46.0
20092010,Tim Connolly,31,30,61,6,3,0.5081967213114754,34.0,44.0
20092010,Scott Nichol,56,47,103,15,3,0.5436893203883495,19.0,27.0
20092010,Maxim Lapierre,41,33,74,19,3,0.5540540540540541,14.0,38.0
20092010,Jeff Halpern,18,24,42,6,3,0.42857142857142855,58.0,52.0
20092010,Jarret Stoll,51,46,97,6,3,0.5257731958762887,25.0,31.0
20092010,Eric Belanger,76,38,114,7,3,0.6666666666666666,2.0,20.0
20092010,Mike Fisher,52,50,102,6,3,0.5098039215686274,33.0,30.0
20092010,Jason Spezza,50,48,98,6,3,0.5102040816326531,32.0,32.0
20092010,Vladimir Sobotka,67,57,124,13,3,0.5403225806451613,20.0,23.0
20092010,Matt Cullen,34,18,52,6,3,0.6538461538461539,3.0,42.0
20092010,Darroll Powe,19,18,37,23,3,0.5135135135135135,28.0,51.0
20092010,Craig Adams,26,33,59,13,3,0.4406779661016949,56.0,49.0
20092010,Jeff Carter,66,62,128,12,3,0.515625,27.0,24.0
20092010,Justin Abdelkader,35,32,67,11,3,0.5223880597014925,26.0,41.0
20092010,Henrik Sedin,155,108,263,12,3,0.5893536121673004,7.0,6.0
20092010,Logan Couture,13,23,36,15,3,0.3611111111111111,69.0,57.0
20092010,Valtteri Filppula,16,18,34,12,3,0.47058823529411764,47.0,54.0
20092010,Stephane Yelle,35,42,77,6,3,0.45454545454545453,50.0,41.0
20092010,Tomas Plekanec,180,202,382,19,3,0.4712041884816754,46.0,4.0
20092010,Dominic Moore,55,79,134,19,3,0.41044776119402987,61.0,28.0
20092010,Paul Stastny,71,69,140,6,3,0.5071428571428571,35.0,22.0
20092010,Daniel Winnik,9,22,31,7,3,0.2903225806451613,70.0,59.0
20092010,Jonathan Toews,277,183,460,22,3,0.6021739130434782,6.0,1.0
20092010,Brendan Morrison,32,25,57,5,3,0.5614035087719298,11.0,43.0
20092010,Marc Savard,45,45,90,7,3,0.5,36.0,35.0
20092010,David Krejci,61,61,122,9,3,0.5,36.0,26.0
20092010,Travis Zajac,46,36,82,5,3,0.5609756097560976,12.0,34.0
20092010,Evgeni Malkin,39,52,91,13,3,0.42857142857142855,58.0,39.0
20092010,Daniel Bri√®re,82,91,173,23,3,0.47398843930635837,44.0,18.0
20092010,Manny Malhotra,125,81,206,15,3,0.6067961165048543,5.0,11.0
20092010,Boyd Gordon,36,17,53,6,3,0.6792452830188679,1.0,40.0
20092010,John Madden,121,116,237,22,3,0.510548523206751,31.0,13.0
20092010,Glen Metropolit,27,38,65,16,3,0.4153846153846154,60.0,48.0
20092010,Rob Niedermayer,28,28,56,5,3,0.5,36.0,47.0
20092010,Marcel Goc,36,37,73,6,3,0.4931506849315068,38.0,40.0
20092010,Derek Roy,46,58,104,6,3,0.4423076923076923,54.0,34.0
20092010,Kris Versteeg,13,19,32,22,3,0.40625,63.0,57.0
20092010,Anze Kopitar,44,48,92,6,3,0.4782608695652174,43.0,36.0
20092010,Tomas Kopecky,17,14,31,17,3,0.5483870967741935,16.0,53.0
20092010,Steve Begin,51,44,95,13,3,0.5368421052631579,21.0,31.0
20092010,Joe Thornton,141,118,259,15,3,0.5444015444015444,18.0,8.0
20092010,Nicklas Backstrom,63,72,135,7,3,0.4666666666666667,48.0,25.0
20092010,Jerred Smithson,30,18,48,6,3,0.625,4.0,45.0
20092010,Patrik Elias,42,44,86,5,3,0.4883720930232558,41.0,37.0
20092010,Adam Mair,14,21,35,6,3,0.4,64.0,56.0
20092010,Scott Gomez,188,194,382,19,3,0.49214659685863876,39.0,3.0
20092010,Blair Betts,152,137,289,23,3,0.5259515570934256,24.0,7.0
20092010,Ryan Kesler,124,110,234,12,3,0.5299145299145299,23.0,12.0
20092010,Joe Pavelski,118,112,230,15,3,0.5130434782608696,29.0,15.0
20092010,Claude Giroux,120,154,274,23,3,0.43795620437956206,57.0,14.0
20092010,Patrick Marleau,27,31,58,14,3,0.46551724137931033,49.0,48.0
20092010,Kyle Wellwood,71,53,124,12,3,0.5725806451612904,10.0,22.0
20092010,Max Talbot,42,52,94,13,3,0.44680851063829785,52.0,37.0
20092010,Dave Bolland,127,196,323,22,3,0.3931888544891641,65.0,10.0
20092010,Jason Arnott,55,60,115,6,3,0.4782608695652174,43.0,28.0
20092010,David Steckel,18,13,31,3,3,0.5806451612903226,8.0,52.0
20092010,Dean McAmmond,15,19,34,5,3,0.4411764705882353,55.0,55.0
20092010,Patrick Sharp,120,121,241,22,3,0.4979253112033195,37.0,14.0
20092010,Ville Leino,13,22,35,19,3,0.37142857142857144,67.0,57.0
20092010,Vernon Fiddler,54,45,99,6,3,0.5454545454545454,17.0,29.0
20092010,David Legwand,25,42,67,6,3,0.373134328358209,66.0,50.0
20092010,Michal Handzus,50,70,120,6,3,0.4166666666666667,59.0,32.0
20092010,Chris Kelly,35,40,75,6,3,0.4666666666666667,48.0,41.0
20102011,Patrick Dwyer,80,158,238,80,2,0.33613445378151263,176.0,152.0
20102011,Zack Smith,209,179,388,55,2,0.538659793814433,39.0,110.0
20102011,Jordan Staal,376,425,801,42,2,0.46941323345817726,120.0,78.0
20102011,Derek MacKenzie,246,227,473,63,2,0.5200845665961945,58.0,100.0
20102011,Mike Richards,606,610,1216,81,2,0.49835526315789475,90.0,30.0
20102011,Ryan O'Reilly,531,494,1025,74,2,0.5180487804878049,61.0,46.0
20102011,Henrik Zetterberg,516,468,984,80,2,0.524390243902439,56.0,48.0
20102011,Torrey Mitchell,99,104,203,66,2,0.4876847290640394,99.0,144.0
20102011,Rod Pelley,169,151,320,74,2,0.528125,48.0,119.0
20102011,Ryan O'Marra,75,103,178,21,2,0.42134831460674155,161.0,155.0
20102011,Pavel Datsyuk,429,356,785,56,2,0.5464968152866242,31.0,68.0
20102011,Vladimir Sobotka,216,203,419,65,2,0.5155131264916468,67.0,108.0
20102011,Darren Helm,493,445,938,82,2,0.5255863539445629,51.0,52.0
20102011,Andrew Cogliano,461,647,1108,82,2,0.41606498194945846,166.0,58.0
20102011,Brad Boyes,136,184,320,83,2,0.425,158.0,126.0
20102011,Paul Gaustad,692,466,1158,81,2,0.5975820379965457,5.0,16.0
20102011,Lars Eller,183,248,431,77,2,0.4245939675174014,159.0,117.0
20102011,Patrik Berglund,450,524,974,81,2,0.4620123203285421,132.0,61.0
20102011,David Desharnais,221,224,445,43,2,0.4966292134831461,92.0,107.0
20102011,Nate Thompson,360,304,664,79,2,0.5421686746987951,35.0,79.0
20102011,Brandon McMillan,114,179,293,60,2,0.3890784982935154,172.0,135.0
20102011,Shawn Horcoff,393,420,813,47,2,0.4833948339483395,107.0,76.0
20102011,Bobby Ryan,87,132,219,82,2,0.3972602739726027,170.0,149.0
20102011,Patrice Bergeron,815,624,1439,80,2,0.56636553161918,15.0,5.0
20102011,Sam Gagner,410,525,935,68,2,0.4385026737967914,151.0,73.0
20102011,Chris Thorburn,125,126,251,82,2,0.49800796812749004,91.0,132.0
20102011,Chris Drury,127,98,225,24,2,0.5644444444444444,18.0,131.0
20102011,John Madden,504,484,988,76,2,0.5101214574898786,70.0,51.0
20102011,Mike Rupp,82,80,162,81,2,0.5061728395061729,79.0,151.0
20102011,Bryan Little,616,715,1331,76,2,0.4628099173553719,129.0,29.0
20102011,Matt Cullen,473,370,843,78,2,0.561091340450771,21.0,56.0
20102011,Martin Hanzal,518,511,1029,61,2,0.5034013605442177,82.0,47.0
20102011,Cody McCormick,132,184,316,81,2,0.4177215189873418,164.0,128.0
20102011,Zenon Konopka,620,455,1075,82,2,0.5767441860465117,9.0,28.0
20102011,Mike Modano,133,141,274,40,2,0.4854014598540146,103.0,127.0
20102011,Sidney Crosby,546,435,981,41,2,0.5565749235474006,23.0,42.0
20102011,Matt Duchene,628,618,1246,80,2,0.5040128410914928,81.0,27.0
20102011,Steven Stamkos,431,496,927,82,2,0.46494066882416396,125.0,66.0
20102011,Marty Reasoner,700,584,1284,82,2,0.5451713395638629,33.0,14.0
20102011,Colin Wilson,108,120,228,82,2,0.47368421052631576,116.0,138.0
20102011,Brandon Dubinsky,459,416,875,77,2,0.5245714285714286,55.0,59.0
20102011,Chris VandeVelde,84,75,159,12,2,0.5283018867924528,46.0,150.0
20102011,Craig Adams,194,271,465,80,2,0.4172043010752688,165.0,113.0
20102011,Jeff Carter,331,274,605,80,2,0.547107438016529,30.0,82.0
20102011,Tyler Seguin,150,153,303,74,2,0.49504950495049505,94.0,124.0
20102011,Matt Stajan,436,409,845,76,2,0.5159763313609468,66.0,65.0
20102011,Tuomo Ruutu,265,378,643,82,2,0.4121306376360809,168.0,95.0
20102011,Antoine Vermette,856,684,1540,82,2,0.5558441558441558,25.0,3.0
20102011,Dominic Moore,475,417,892,77,2,0.5325112107623319,44.0,54.0
20102011,Brendan Morrison,378,384,762,66,2,0.49606299212598426,93.0,77.0
20102011,Tim Connolly,445,524,969,68,2,0.45923632610939114,134.0,64.0
20102011,Scott Nichol,288,197,485,56,2,0.5938144329896907,6.0,89.0
20102011,Frans Nielsen,446,519,965,71,2,0.46217616580310883,131.0,63.0
20102011,Tim Stapleton,109,116,225,45,2,0.48444444444444446,105.0,137.0
20102011,Justin Abdelkader,227,203,430,74,2,0.5279069767441861,50.0,105.0
20102011,Cal O'Reilly,231,266,497,38,2,0.4647887323943662,126.0,104.0
20102011,Mathieu Perreault,139,166,305,35,2,0.4557377049180328,138.0,125.0
20102011,Andrew Ebbett,104,125,229,33,2,0.45414847161572053,139.0,141.0
20102011,Tomas Fleischmann,99,137,236,45,2,0.4194915254237288,163.0,144.0
20102011,Paul Stastny,810,714,1524,74,2,0.531496062992126,45.0,6.0
20102011,Daniel Bri√®re,395,425,820,77,2,0.4817073170731707,109.0,75.0
20102011,David Moss,157,207,364,58,2,0.43131868131868134,154.0,121.0
20102011,Trevor Lewis,151,234,385,72,2,0.3922077922077922,171.0,123.0
20102011,Jeff Skinner,58,99,157,82,2,0.36942675159235666,175.0,158.0
20102011,Alexander Burmistrov,289,407,696,74,2,0.41522988505747127,167.0,88.0
20102011,Shawn Matthias,188,182,370,51,2,0.5081081081081081,77.0,115.0
20102011,Mikael Backlund,319,345,664,73,2,0.48042168674698793,110.0,83.0
20102011,Derek Stepan,277,442,719,82,2,0.3852573018080668,173.0,90.0
20102011,Jacob Josefson,95,107,202,28,2,0.47029702970297027,118.0,146.0
20102011,Gilbert Brule,106,93,199,41,2,0.5326633165829145,43.0,140.0
20102011,Tim Brent,410,378,788,79,2,0.5203045685279187,57.0,73.0
20102011,Tomas Plekanec,788,789,1577,77,2,0.49968294229549776,88.0,7.0
20102011,Philippe Dupuis,153,178,331,74,2,0.4622356495468278,130.0,122.0
20102011,Todd Marchant,263,285,548,79,2,0.47992700729927007,113.0,96.0
20102011,Jarret Stoll,753,557,1310,82,2,0.5748091603053435,10.0,10.0
20102011,Jesse Winchester,303,242,545,72,2,0.5559633027522936,24.0,87.0
20102011,Mark Letestu,407,327,734,64,2,0.5544959128065395,26.0,74.0
20102011,Artem Anisimov,306,382,688,82,2,0.44476744186046513,144.0,86.0
20102011,Vincent Lecavalier,591,570,1161,65,2,0.5090439276485789,73.0,34.0
20102011,Jarome Iginla,227,193,420,82,2,0.5404761904761904,36.0,105.0
20102011,Ryan Getzlaf,542,641,1183,67,2,0.45815722738799664,137.0,43.0
20102011,Henrik Sedin,721,666,1387,82,2,0.5198269646719539,60.0,11.0
20102011,Jason Pominville,67,88,155,73,2,0.432258064516129,153.0,157.0
20102011,Kyle Brodziak,532,556,1088,80,2,0.4889705882352941,97.0,45.0
20102011,Eric Staal,840,911,1751,81,2,0.47972587093089664,114.0,4.0
20102011,Boyd Gordon,417,302,719,60,2,0.5799721835883171,8.0,70.0
20102011,Evgeni Malkin,77,123,200,43,2,0.385,174.0,154.0
20102011,Dustin Jeffrey,109,138,247,25,2,0.44129554655870445,148.0,137.0
20102011,Erik Christensen,316,323,639,63,2,0.4945226917057903,95.0,84.0
20102011,Jussi Jokinen,169,151,320,70,2,0.528125,48.0,119.0
20102011,Darryl Boyce,212,245,457,46,2,0.4638949671772429,128.0,109.0
20102011,R.J. Umberger,111,109,220,82,2,0.5045454545454545,80.0,136.0
20102011,Tim Sestito,116,137,253,36,2,0.45849802371541504,136.0,134.0
20102011,Marcus Johansson,271,398,669,69,2,0.40508221225710017,169.0,92.0
20102011,Jochen Hecht,314,415,729,67,2,0.43072702331961593,156.0,85.0
20102011,Ryan Shannon,87,120,207,79,2,0.42028985507246375,162.0,149.0
20102011,Jason Spezza,681,529,1210,62,2,0.5628099173553719,20.0,20.0
20102011,Logan Couture,474,414,888,79,2,0.5337837837837838,42.0,55.0
20102011,Tyler Bozak,787,654,1441,82,2,0.546148507980569,32.0,8.0
20102011,Valtteri Filppula,478,450,928,71,2,0.5150862068965517,68.0,53.0
20102011,Logan Couture,474,414,888,79,2,0.5337837837837838,42.0,55.0
20102011,Tyler Bozak,787,654,1441,82,2,0.546148507980569,32.0,8.0
20102011,Valtteri Filppula,478,450,928,71,2,0.5150862068965517,68.0,53.0
20102011,Brian Boyle,534,567,1101,82,2,0.48501362397820164,104.0,44.0
20102011,Adam Burish,255,222,477,63,2,0.5345911949685535,40.0,98.0
20102011,Dustin Penner,131,175,306,81,2,0.42810457516339867,157.0,129.0
20102011,Shane Doan,73,86,159,72,2,0.4591194968553459,135.0,156.0
20102011,Joel Ward,82,86,168,80,2,0.4880952380952381,98.0,151.0
20102011,Tomas Kopecky,120,164,284,81,2,0.4225352112676056,160.0,133.0
20102011,Steve Ott,644,494,1138,82,2,0.5659050966608085,16.0,25.0
20102011,Rob Schremp,224,262,486,63,2,0.4609053497942387,133.0,106.0
20102011,Brad Richardson,92,89,181,68,2,0.5082872928176796,76.0,147.0
20102011,David Backes,506,632,1138,82,2,0.4446397188049209,145.0,50.0
20102011,John Tavares,693,626,1319,79,2,0.5253980288097043,52.0,15.0
20102011,Mikhail Grabovski,642,684,1326,81,2,0.4841628959276018,106.0,26.0
20102011,Patrik Elias,224,274,498,81,2,0.4497991967871486,141.0,106.0
20102011,Ryan Johnson,197,115,312,34,2,0.6314102564102564,1.0,112.0
20102011,Jeff Halpern,338,256,594,72,2,0.569023569023569,13.0,81.0
20102011,Scott Gomez,575,622,1197,80,2,0.4803675856307435,111.0,36.0
20102011,Blair Betts,411,406,817,75,2,0.5030599755201959,83.0,72.0
20102011,Ryan Kesler,859,637,1496,82,2,0.5741978609625669,12.0,2.0
20102011,Steve Reinprecht,89,83,172,29,2,0.5174418604651163,62.0,148.0
20102011,Jay McClement,595,557,1152,80,2,0.5164930555555556,65.0,33.0
20102011,Andy McDonald,207,142,349,58,2,0.5931232091690545,7.0,111.0
20102011,Joe Pavelski,554,466,1020,74,2,0.5431372549019607,34.0,39.0
20102011,Craig Conroy,101,88,189,18,2,0.5343915343915344,41.0,142.0
20102011,Claude Giroux,548,547,1095,82,2,0.5004566210045662,86.0,41.0
20102011,Kyle Turris,270,270,540,65,2,0.5,87.0,93.0
20102011,Dave Bolland,455,553,1008,61,2,0.4513888888888889,140.0,60.0
20102011,Colin Fraser,246,306,552,67,2,0.44565217391304346,142.0,100.0
20102011,Patrick Marleau,288,261,549,82,2,0.5245901639344263,54.0,89.0
20102011,Gregory Campbell,430,402,832,80,2,0.5168269230769231,63.0,67.0
20102011,Maxim Lapierre,173,167,340,78,2,0.5088235294117647,74.0,118.0
20102011,Max Talbot,425,449,874,82,2,0.4862700228832952,102.0,69.0
20102011,Teemu Selanne,97,121,218,73,2,0.44495412844036697,143.0,145.0
20102011,Brandon Sutter,598,751,1349,82,2,0.44329132690882134,147.0,32.0
20102011,Brooks Laich,269,255,524,82,2,0.5133587786259542,69.0,94.0
20102011,Jonathan Toews,937,716,1653,80,2,0.5668481548699335,14.0,1.0
20102011,David Steckel,511,309,820,75,2,0.6231707317073171,2.0,49.0
20102011,Jim Slater,185,116,301,36,2,0.6146179401993356,4.0,116.0
20102011,Tom Wandell,190,245,435,75,2,0.4367816091954023,152.0,114.0
20102011,Travis Zajac,707,571,1278,82,2,0.55320813771518,27.0,13.0
20102011,Nik Antropov,260,274,534,76,2,0.4868913857677903,101.0,97.0
20102011,Eric Belanger,717,580,1297,82,2,0.5528141865844256,28.0,12.0
20102011,David Krejci,560,589,1149,75,2,0.48738033072236725,100.0,38.0
20102011,Marc Savard,167,161,328,25,2,0.5091463414634146,71.0,120.0
20102011,Derick Brassard,414,474,888,74,2,0.46621621621621623,123.0,71.0
20102011,Olli Jokinen,552,613,1165,79,2,0.4738197424892704,115.0,40.0
20102011,Jerred Smithson,578,428,1006,82,2,0.5745526838966203,11.0,35.0
20102011,Chris Kelly,466,450,916,81,2,0.5087336244541485,75.0,57.0
20102011,Josh Bailey,273,342,615,70,2,0.44390243902439025,146.0,91.0
20102011,Nick Spaling,253,244,497,74,2,0.5090543259557344,72.0,99.0
20102011,Manny Malhotra,778,483,1261,72,2,0.6169706582077716,3.0,9.0
20102011,Dainius Zubrus,253,196,449,79,2,0.5634743875278396,19.0,99.0
20102011,Mikko Koivu,683,610,1293,71,2,0.5282289249806651,47.0,19.0
20102011,Nicklas Backstrom,690,625,1315,77,2,0.5247148288973384,53.0,17.0
20102011,Stephen Weiss,689,590,1279,76,2,0.5387021110242377,38.0,18.0
20102011,Samuel Pahlsson,675,623,1298,82,2,0.5200308166409862,59.0,22.0
20102011,Patrick Sharp,244,264,508,74,2,0.48031496062992124,112.0,102.0
20102011,Rob Niedermayer,129,147,276,71,2,0.4673913043478261,121.0,130.0
20102011,Adam Hall,360,295,655,82,2,0.549618320610687,29.0,79.0
20102011,Vernon Fiddler,660,564,1224,71,2,0.5392156862745098,37.0,23.0
20102011,David Legwand,395,442,837,64,2,0.47192353643966545,117.0,75.0
20102011,Saku Koivu,707,632,1339,75,2,0.5280059746079163,49.0,13.0
20102011,Mike Santorelli,518,514,1032,82,2,0.501937984496124,85.0,47.0
20102011,Michal Handzus,678,634,1312,82,2,0.5167682926829268,64.0,21.0
20102011,Rich Peverley,657,519,1176,82,2,0.5586734693877551,22.0,24.0
20102011,Peter Regin,132,184,316,55,2,0.4177215189873418,164.0,128.0
20102011,Jamie Benn,84,111,195,69,2,0.4307692307692308,155.0,150.0
20102011,T.J. Oshie,100,127,227,49,2,0.44052863436123346,149.0,143.0
20102011,Mike Ribeiro,565,648,1213,82,2,0.46578730420445175,124.0,37.0
20102011,Kyle Chipchura,132,151,283,40,2,0.4664310954063604,122.0,128.0
20102011,Mike Fisher,602,644,1246,82,2,0.48314606741573035,108.0,31.0
20102011,Lauri Korpikoski,107,137,244,79,2,0.4385245901639344,150.0,139.0
20102011,Jason Arnott,449,445,894,73,2,0.5022371364653244,84.0,62.0
20102011,Nick Bonino,78,88,166,26,2,0.46987951807228917,119.0,153.0
20102011,Ryan Carter,242,236,478,62,2,0.5062761506276151,78.0,103.0
20102011,Marcel Goc,346,347,693,51,2,0.49927849927849927,89.0,80.0
20102011,Kris Draper,95,73,168,47,2,0.5654761904761905,17.0,146.0
20102011,Derek Roy,245,283,528,35,2,0.4640151515151515,127.0,101.0
20102011,Jake Dowell,319,333,652,79,2,0.4892638036809816,96.0,83.0
20102011,Michael Frolik,20,25,45,7,3,0.4444444444444444,61.0,53.0
20102011,Jordan Staal,83,84,167,7,3,0.49700598802395207,40.0,17.0
20102011,Mike Richards,61,85,146,11,3,0.4178082191780822,67.0,27.0
20102011,Henrik Zetterberg,64,65,129,7,3,0.49612403100775193,41.0,25.0
20102011,Drew Stafford,15,16,31,7,3,0.4838709677419355,48.0,56.0
20102011,Pavel Datsyuk,79,64,143,11,3,0.5524475524475524,16.0,18.0
20102011,Darren Helm,26,38,64,11,3,0.40625,70.0,47.0
20102011,Paul Gaustad,73,60,133,7,3,0.5488721804511278,18.0,21.0
20102011,Lars Eller,22,29,51,7,3,0.43137254901960786,64.0,51.0
20102011,Nate Thompson,70,82,152,18,3,0.4605263157894737,57.0,22.0
20102011,Patrice Bergeron,299,198,497,23,3,0.6016096579476862,7.0,2.0
20102011,Torrey Mitchell,20,11,31,18,3,0.6451612903225806,4.0,53.0
20102011,Chris Drury,44,26,70,5,3,0.6285714285714286,5.0,35.0
20102011,Martin Hanzal,43,39,82,4,3,0.524390243902439,27.0,36.0
20102011,Mike Rupp,18,15,33,7,3,0.5454545454545454,22.0,54.0
20102011,Steven Stamkos,95,92,187,18,3,0.5080213903743316,37.0,14.0
20102011,Mark Recchi,18,20,38,25,3,0.47368421052631576,51.0,54.0
20102011,Dominic Moore,110,117,227,18,3,0.4845814977973568,47.0,12.0
20102011,Tim Connolly,63,58,121,6,3,0.5206611570247934,30.0,26.0
20102011,Scott Nichol,52,48,100,15,3,0.52,31.0,30.0
20102011,Jarret Stoll,51,42,93,5,3,0.5483870967741935,19.0,31.0
20102011,Kyle Wellwood,21,11,32,18,3,0.65625,3.0,52.0
20102011,Mark Letestu,45,48,93,7,3,0.4838709677419355,48.0,34.0
20102011,Vincent Lecavalier,187,188,375,18,3,0.49866666666666665,39.0,6.0
20102011,Marcus Johansson,39,56,95,9,3,0.4105263157894737,68.0,38.0
20102011,Erik Christensen,25,17,42,5,3,0.5952380952380952,8.0,48.0
20102011,Artem Anisimov,18,21,39,5,3,0.46153846153846156,56.0,54.0
20102011,Justin Abdelkader,43,34,77,11,3,0.5584415584415584,13.0,36.0
20102011,Darroll Powe,17,14,31,11,3,0.5483870967741935,19.0,55.0
20102011,Craig Adams,24,22,46,7,3,0.5217391304347826,28.0,49.0
20102011,Brandon Dubinsky,33,52,85,5,3,0.38823529411764707,75.0,42.0
20102011,Ryan Getzlaf,69,77,146,6,3,0.4726027397260274,52.0,23.0
20102011,Henrik Sedin,228,270,498,25,3,0.4578313253012048,59.0,3.0
20102011,Logan Couture,105,127,232,18,3,0.4525862068965517,60.0,13.0
20102011,Valtteri Filppula,68,74,142,11,3,0.4788732394366197,49.0,24.0
20102011,Brian Boyle,43,44,87,5,3,0.4942528735632184,42.0,36.0
20102011,Derek Stepan,12,18,30,5,3,0.4,72.0,57.0
20102011,Tomas Plekanec,68,89,157,7,3,0.43312101910828027,63.0,24.0
20102011,Jonathan Toews,86,68,154,7,3,0.5584415584415584,13.0,16.0
20102011,Rich Peverley,91,79,170,25,3,0.5352941176470588,25.0,15.0
20102011,Maxim Lapierre,130,125,255,25,3,0.5098039215686274,36.0,8.0
20102011,Eric Belanger,32,26,58,4,3,0.5517241379310345,17.0,43.0
20102011,David Krejci,202,188,390,25,3,0.517948717948718,32.0,4.0
20102011,Brooks Laich,61,49,110,9,3,0.5545454545454546,15.0,27.0
20102011,Mike Fisher,117,130,247,12,3,0.47368421052631576,51.0,11.0
20102011,Chris Kelly,124,135,259,25,3,0.47876447876447875,50.0,9.0
20102011,Boyd Gordon,77,35,112,9,3,0.6875,2.0,19.0
20102011,Jason Arnott,63,70,133,9,3,0.47368421052631576,51.0,26.0
20102011,Trevor Lewis,22,33,55,6,3,0.4,72.0,51.0
20102011,Todd Marchant,25,26,51,6,3,0.49019607843137253,44.0,48.0
20102011,Daniel Bri√®re,50,48,98,11,3,0.5102040816326531,35.0,32.0
20102011,Joel Ward,15,23,38,12,3,0.39473684210526316,73.0,56.0
20102011,Joe Thornton,199,137,336,18,3,0.5922619047619048,9.0,5.0
20102011,Brad Richardson,27,36,63,6,3,0.42857142857142855,65.0,46.0
20102011,Cody Hodgson,23,26,49,12,3,0.46938775510204084,54.0,50.0
20102011,Nick Spaling,59,52,111,12,3,0.5315315315315315,26.0,28.0
20102011,Manny Malhotra,37,34,71,6,3,0.5211267605633803,29.0,39.0
20102011,Nicklas Backstrom,75,88,163,9,3,0.4601226993865031,58.0,20.0
20102011,Jerred Smithson,53,44,97,11,3,0.5463917525773195,21.0,29.0
20102011,Ryan Johnson,17,13,30,6,3,0.5666666666666667,11.0,55.0
20102011,Jeff Halpern,30,11,41,4,3,0.7317073170731707,1.0,44.0
20102011,Scott Gomez,48,70,118,7,3,0.4067796610169492,69.0,33.0
20102011,Blair Betts,53,82,135,11,3,0.3925925925925926,74.0,29.0
20102011,Ryan Kesler,329,279,608,25,3,0.5411184210526315,23.0,1.0
20102011,Joe Pavelski,162,134,296,18,3,0.5472972972972973,20.0,7.0
20102011,Brad Boyes,26,20,46,7,3,0.5652173913043478,12.0,47.0
20102011,Patrick Sharp,34,22,56,7,3,0.6071428571428571,6.0,41.0
20102011,Ville Leino,12,22,34,11,3,0.35294117647058826,76.0,57.0
20102011,Adam Hall,91,68,159,18,3,0.5723270440251572,10.0,15.0
20102011,Vernon Fiddler,20,25,45,4,3,0.4444444444444444,61.0,53.0
20102011,David Legwand,124,123,247,12,3,0.5020242914979757,38.0,9.0
20102011,Saku Koivu,50,47,97,6,3,0.5154639175257731,33.0,32.0
20102011,Michal Handzus,59,82,141,6,3,0.41843971631205673,66.0,28.0
20102011,Rob Niedermayer,29,30,59,7,3,0.4915254237288136,43.0,45.0
20102011,Kyle Turris,18,19,37,4,3,0.4864864864864865,46.0,54.0
20102011,Dave Bolland,36,45,81,4,3,0.4444444444444444,61.0,40.0
20102011,Gregory Campbell,75,110,185,25,3,0.40540540540540543,71.0,20.0
20102011,Chris Higgins,18,17,35,25,3,0.5142857142857142,34.0,54.0
20102011,Blake Geoffrion,27,23,50,12,3,0.54,24.0,46.0
20102011,Max Talbot,51,58,109,7,3,0.46788990825688076,55.0,31.0
20102011,Mason Raymond,20,21,41,24,3,0.4878048780487805,45.0,53.0
20102011,Patrick Marleau,42,47,89,18,3,0.47191011235955055,53.0,37.0
20102011,Claude Giroux,122,97,219,11,3,0.5570776255707762,14.0,10.0
20102011,Kris Draper,23,29,52,8,3,0.4423076923076923,62.0,50.0
20112012,John Madden,155,158,313,31,2,0.4952076677316294,89.0,123.0
20112012,Zack Smith,484,506,990,81,2,0.4888888888888889,100.0,53.0
20112012,Jordan Staal,591,567,1158,62,2,0.5103626943005182,73.0,33.0
20112012,Andrew Cogliano,162,224,386,82,2,0.41968911917098445,167.0,120.0
20112012,Derek MacKenzie,234,195,429,66,2,0.5454545454545454,29.0,97.0
20112012,Blair Jones,128,174,302,43,2,0.423841059602649,161.0,135.0
20112012,Craig Smith,173,220,393,72,2,0.4402035623409669,149.0,118.0
20112012,Luke Adam,114,145,259,52,2,0.44015444015444016,150.0,142.0
20112012,Ryan O'Reilly,762,681,1443,81,2,0.5280665280665281,44.0,9.0
20112012,Henrik Zetterberg,548,567,1115,82,2,0.4914798206278027,97.0,42.0
20112012,Zenon Konopka,232,162,394,55,2,0.5888324873096447,5.0,98.0
20112012,Pavel Datsyuk,702,547,1249,70,2,0.5620496397117695,15.0,13.0
20112012,Vladimir Sobotka,281,220,501,73,2,0.5608782435129741,19.0,87.0
20112012,Stephane Da Costa,65,112,177,22,2,0.3672316384180791,172.0,158.0
20112012,Darren Helm,403,374,777,68,2,0.5186615186615187,57.0,62.0
20112012,Ryan Nugent-Hopkins,227,378,605,62,2,0.3752066115702479,171.0,100.0
20112012,Dominic Moore,419,343,762,79,2,0.5498687664041995,26.0,59.0
20112012,Nik Antropov,283,369,652,69,2,0.4340490797546012,156.0,86.0
20112012,Lars Eller,319,366,685,79,2,0.4656934306569343,124.0,79.0
20112012,Patrik Berglund,567,601,1168,82,2,0.4854452054794521,106.0,38.0
20112012,Patrick Kane,240,329,569,82,2,0.421792618629174,164.0,95.0
20112012,Ryan Carter,215,217,432,72,2,0.4976851851851852,86.0,104.0
20112012,David Desharnais,678,693,1371,81,2,0.49452954048140046,92.0,15.0
20112012,Nate Thompson,293,299,592,68,2,0.49493243243243246,90.0,84.0
20112012,Shawn Horcoff,728,747,1475,81,2,0.4935593220338983,94.0,11.0
20112012,Patrice Bergeron,973,668,1641,81,2,0.5929311395490554,4.0,1.0
20112012,Sam Gagner,334,367,701,75,2,0.4764621968616263,115.0,76.0
20112012,Kyle Chipchura,174,190,364,53,2,0.47802197802197804,112.0,117.0
20112012,Brad Richards,682,634,1316,82,2,0.5182370820668692,58.0,14.0
20112012,Scott Nichol,259,191,450,80,2,0.5755555555555556,11.0,90.0
20112012,Matt Hendricks,142,123,265,78,2,0.5358490566037736,36.0,128.0
20112012,Matt Cullen,627,551,1178,73,2,0.532258064516129,39.0,30.0
20112012,Ryan Smyth,66,84,150,82,2,0.44,151.0,157.0
20112012,Tim Stapleton,97,119,216,63,2,0.44907407407407407,142.0,148.0
20112012,Matt Read,142,204,346,79,2,0.41040462427745666,170.0,128.0
20112012,Martin Hanzal,571,526,1097,64,2,0.5205104831358249,53.0,37.0
20112012,Mikael Backlund,225,271,496,41,2,0.4536290322580645,134.0,101.0
20112012,Brayden Schenn,201,235,436,54,2,0.4610091743119266,128.0,107.0
20112012,Tim Brent,278,293,571,79,2,0.4868651488616462,104.0,88.0
20112012,Justin Abdelkader,239,213,452,81,2,0.5287610619469026,43.0,96.0
20112012,Adam Henrique,501,525,1026,74,2,0.48830409356725146,102.0,52.0
20112012,Mathieu Perreault,229,222,451,64,2,0.5077605321507761,75.0,99.0
20112012,Alexander Burmistrov,248,316,564,76,2,0.4397163120567376,152.0,93.0
20112012,Eric Staal,882,799,1681,82,2,0.5246876859012493,48.0,3.0
20112012,Daniel Bri√®re,406,425,831,70,2,0.48856799037304455,101.0,61.0
20112012,Matthew Lombardi,151,155,306,62,2,0.4934640522875817,95.0,124.0
20112012,Trevor Lewis,87,112,199,72,2,0.4371859296482412,154.0,152.0
20112012,Tom Pyatt,128,153,281,74,2,0.4555160142348754,132.0,135.0
20112012,Jeff Skinner,67,92,159,64,2,0.42138364779874216,165.0,156.0
20112012,David Moss,93,127,220,32,2,0.42272727272727273,162.0,151.0
20112012,Michal Handzus,413,402,815,67,2,0.5067484662576687,78.0,60.0
20112012,Sidney Crosby,227,226,453,22,2,0.5011037527593819,84.0,100.0
20112012,Matt Duchene,200,191,391,58,2,0.5115089514066496,70.0,108.0
20112012,Steven Stamkos,558,669,1227,82,2,0.4547677261613692,133.0,40.0
20112012,Kyle Wellwood,135,115,250,77,2,0.54,31.0,133.0
20112012,Marcus Johansson,307,403,710,80,2,0.4323943661971831,159.0,81.0
20112012,Jochen Hecht,136,164,300,22,2,0.4533333333333333,135.0,132.0
20112012,Jason Spezza,909,791,1700,80,2,0.5347058823529411,37.0,2.0
20112012,Ville Leino,95,135,230,71,2,0.41304347826086957,169.0,149.0
20112012,Craig Adams,132,160,292,82,2,0.4520547945205479,138.0,134.0
20112012,Derek Stepan,386,481,867,82,2,0.44521337946943484,144.0,65.0
20112012,Jerred Smithson,362,283,645,69,2,0.5612403100775194,16.0,70.0
20112012,Vernon Fiddler,534,515,1049,82,2,0.5090562440419447,74.0,47.0
20112012,Jamal Mayers,313,245,558,81,2,0.5609318996415771,17.0,80.0
20112012,Jacob Josefson,181,173,354,41,2,0.5112994350282486,71.0,114.0
20112012,Tomas Plekanec,824,854,1678,81,2,0.49106078665077474,98.0,5.0
20112012,Warren Peters,255,210,465,58,2,0.5483870967741935,28.0,91.0
20112012,Evgeni Malkin,575,635,1210,75,2,0.47520661157024796,117.0,36.0
20112012,Michael Cammalleri,104,124,228,66,2,0.45614035087719296,131.0,145.0
20112012,Dustin Jeffrey,109,116,225,26,2,0.48444444444444446,107.0,144.0
20112012,Frans Nielsen,523,633,1156,82,2,0.4524221453287197,137.0,48.0
20112012,David Clarkson,102,141,243,80,2,0.41975308641975306,166.0,147.0
20112012,Jussi Jokinen,459,374,833,79,2,0.5510204081632653,25.0,56.0
20112012,R.J. Umberger,150,156,306,77,2,0.49019607843137253,99.0,125.0
20112012,Jim Slater,634,531,1165,78,2,0.544206008583691,30.0,27.0
20112012,Mark Letestu,375,347,722,62,2,0.5193905817174516,55.0,68.0
20112012,Bryan Little,733,746,1479,74,2,0.495605138607167,87.0,10.0
20112012,Marty Reasoner,303,269,572,61,2,0.5297202797202797,42.0,82.0
20112012,Matt Stajan,331,308,639,61,2,0.5179968701095462,59.0,77.0
20112012,Darryl Boyce,84,79,163,37,2,0.5153374233128835,65.0,153.0
20112012,Tyler Ennis,145,171,316,48,2,0.4588607594936709,129.0,127.0
20112012,Chris Kelly,419,390,809,82,2,0.5179233621755254,60.0,59.0
20112012,Shawn Matthias,295,302,597,79,2,0.49413735343383586,93.0,83.0
20112012,Jeff Halpern,365,260,625,69,2,0.584,8.0,69.0
20112012,Marcus Kruger,284,335,619,71,2,0.4588045234248788,130.0,85.0
20112012,Brandon Dubinsky,205,190,395,77,2,0.5189873417721519,56.0,105.0
20112012,Anton Lander,149,195,344,56,2,0.4331395348837209,157.0,126.0
20112012,Joe Vitale,403,320,723,68,2,0.5573997233748271,21.0,62.0
20112012,Logan Couture,468,442,910,80,2,0.5142857142857142,67.0,54.0
20112012,Tyler Bozak,631,567,1198,73,2,0.5267111853088481,45.0,28.0
20112012,Valtteri Filppula,193,180,373,81,2,0.517426273458445,63.0,110.0
20112012,Kyle Turris,338,385,723,55,2,0.46749654218533887,122.0,75.0
20112012,Brian Boyle,629,586,1215,82,2,0.5176954732510288,61.0,29.0
20112012,Cory Emmerton,151,162,313,71,2,0.48242811501597443,110.0,124.0
20112012,Johan Franzen,79,100,179,77,2,0.441340782122905,147.0,154.0
20112012,Adam Burish,217,172,389,65,2,0.5578406169665809,20.0,103.0
20112012,Antoine Vermette,645,495,1140,82,2,0.5657894736842105,14.0,25.0
20112012,Jarret Stoll,662,542,1204,78,2,0.5498338870431894,27.0,20.0
20112012,Jesse Winchester,126,109,235,32,2,0.5361702127659574,34.0,136.0
20112012,Artem Anisimov,161,184,345,79,2,0.4666666666666667,123.0,121.0
20112012,Matt Stajan,331,308,639,61,2,0.5179968701095462,59.0,77.0
20112012,Darryl Boyce,84,79,163,37,2,0.5153374233128835,65.0,153.0
20112012,Alexander Burmistrov,248,316,564,76,2,0.4397163120567376,152.0,93.0
20112012,Eric Staal,882,799,1681,82,2,0.5246876859012493,48.0,3.0
20112012,Daniel Bri√®re,406,425,831,70,2,0.48856799037304455,101.0,61.0
20112012,David Moss,93,127,220,32,2,0.42272727272727273,162.0,151.0
20112012,Trevor Lewis,87,112,199,72,2,0.4371859296482412,154.0,152.0
20112012,Tom Pyatt,128,153,281,74,2,0.4555160142348754,132.0,135.0
20112012,Jeff Skinner,67,92,159,64,2,0.42138364779874216,165.0,156.0
20112012,Matthew Lombardi,151,155,306,62,2,0.4934640522875817,95.0,124.0
20112012,Mike Richards,539,528,1067,74,2,0.5051546391752577,80.0,45.0
20112012,Jay McClement,448,425,873,80,2,0.5131729667812142,69.0,57.0
20112012,Max Talbot,284,356,640,81,2,0.44375,146.0,85.0
20112012,Joe Thornton,557,436,993,82,2,0.5609264853977844,18.0,41.0
20112012,Anze Kopitar,763,655,1418,82,2,0.5380818053596615,32.0,8.0
20112012,David Backes,658,695,1353,82,2,0.48632668144863267,105.0,22.0
20112012,John Tavares,814,772,1586,82,2,0.5132408575031526,68.0,6.0
20112012,Mikhail Grabovski,466,439,905,74,2,0.5149171270718232,66.0,55.0
20112012,Patrik Elias,604,765,1369,81,2,0.4411979547114682,148.0,32.0
20112012,Matt Ellis,117,127,244,60,2,0.47950819672131145,111.0,141.0
20112012,Steve Ott,561,450,1011,74,2,0.5548961424332344,23.0,39.0
20112012,Eric Belanger,557,450,1007,78,2,0.5531281032770605,24.0,41.0
20112012,Jim O'Brien,121,135,256,28,2,0.47265625,119.0,138.0
20112012,Scott Gomez,165,168,333,38,2,0.4954954954954955,88.0,119.0
20112012,Maxime Macenauer,113,114,227,29,2,0.4977973568281938,85.0,143.0
20112012,Ryan Kesler,724,627,1351,77,2,0.535899333826795,35.0,12.0
20112012,John Mitchell,103,96,199,63,2,0.5175879396984925,62.0,146.0
20112012,Brendan Morrison,195,199,394,39,2,0.4949238578680203,91.0,109.0
20112012,Teemu Selanne,145,155,300,82,2,0.48333333333333334,109.0,127.0
20112012,Brandon Sutter,654,641,1295,82,2,0.505019305019305,81.0,23.0
20112012,Brooks Laich,664,730,1394,82,2,0.4763271162123386,116.0,19.0
20112012,Jonathan Toews,675,462,1137,59,2,0.5936675461741425,3.0,16.0
20112012,Rich Peverley,203,129,332,57,2,0.6114457831325302,1.0,106.0
20112012,Patrick Marleau,243,224,467,82,2,0.5203426124197003,54.0,94.0
20112012,Jeff Carter,393,381,774,55,2,0.5077519379844961,76.0,63.0
20112012,Marcel Goc,505,473,978,57,2,0.516359918200409,64.0,51.0
20112012,Gregory Campbell,344,334,678,78,2,0.5073746312684366,77.0,73.0
20112012,Claude Giroux,828,715,1543,77,2,0.5366169799092677,33.0,4.0
20112012,Dave Bolland,582,621,1203,76,2,0.4837905236907731,108.0,35.0
20112012,Cal O'Reilly,120,148,268,33,2,0.44776119402985076,143.0,139.0
20112012,Joe Pavelski,507,357,864,82,2,0.5868055555555556,6.0,50.0
20112012,Richard Park,221,176,397,54,2,0.5566750629722922,22.0,102.0
20112012,David Krejci,544,501,1045,79,2,0.5205741626794258,52.0,43.0
20112012,Sean Couturier,378,426,804,77,2,0.4701492537313433,121.0,67.0
20112012,Petteri Nokelainen,165,144,309,56,2,0.5339805825242718,38.0,119.0
20112012,Derick Brassard,278,339,617,74,2,0.4505672609400324,140.0,88.0
20112012,Olli Jokinen,620,713,1333,82,2,0.46511627906976744,125.0,31.0
20112012,Samuel Pahlsson,540,486,1026,80,2,0.5263157894736842,47.0,44.0
20112012,Josh Bailey,323,413,736,80,2,0.4388586956521739,153.0,78.0
20112012,Paul Gaustad,659,491,1150,70,2,0.5730434782608695,12.0,21.0
20112012,Nick Spaling,448,446,894,77,2,0.5011185682326622,83.0,57.0
20112012,Manny Malhotra,536,380,916,78,2,0.5851528384279476,7.0,46.0
20112012,Dainius Zubrus,191,250,441,82,2,0.4331065759637188,158.0,112.0
20112012,Maxim Lapierre,251,231,482,82,2,0.520746887966805,51.0,92.0
20112012,Tom Wandell,141,183,324,72,2,0.4351851851851852,155.0,129.0
20112012,Jake Dowell,94,103,197,52,2,0.47715736040609136,114.0,150.0
20112012,Ryan Johansen,97,118,215,67,2,0.4511627906976744,139.0,148.0
20112012,Travis Zajac,118,86,204,15,2,0.5784313725490197,10.0,140.0
20112012,Mikko Koivu,587,536,1123,55,2,0.5227070347284061,50.0,34.0
20112012,Nicklas Backstrom,353,338,691,42,2,0.5108538350217077,72.0,71.0
20112012,Jason Arnott,387,382,769,72,2,0.5032509752925878,82.0,64.0
20112012,TJ Galiardi,75,92,167,69,2,0.4491017964071856,141.0,155.0
20112012,Boyd Gordon,669,508,1177,75,2,0.5683942225998301,13.0,18.0
20112012,David Legwand,512,597,1109,78,2,0.4616771866546438,127.0,49.0
20112012,Tomas Kopecky,140,126,266,80,2,0.5263157894736842,47.0,130.0
20112012,Patrick Sharp,139,152,291,74,2,0.47766323024054985,113.0,131.0
20112012,Adam Hall,276,188,464,57,2,0.5948275862068966,2.0,89.0
20112012,Erik Christensen,159,143,302,49,2,0.5264900662251656,46.0,122.0
20112012,Tim Connolly,383,403,786,70,2,0.4872773536895674,103.0,66.0
20112012,Stephen Weiss,781,688,1469,80,2,0.5316541865214431,40.0,7.0
20112012,Roman Horak,183,258,441,61,2,0.41496598639455784,168.0,113.0
20112012,Brad Boyes,126,141,267,65,2,0.47191011235955055,120.0,136.0
20112012,David Steckel,643,465,1108,76,2,0.5803249097472925,9.0,26.0
20112012,Nick Bonino,195,259,454,50,2,0.42951541850220265,160.0,109.0
20112012,Mike Ribeiro,341,467,808,74,2,0.422029702970297,163.0,74.0
20112012,Colin Fraser,175,195,370,67,2,0.47297297297297297,118.0,116.0
20112012,Rod Pelley,125,129,254,52,2,0.4921259842519685,96.0,137.0
20112012,Daymond Langkow,440,551,991,73,2,0.4439959636730575,145.0,58.0
20112012,Derek Roy,672,657,1329,80,2,0.5056433408577878,79.0,17.0
20112012,Saku Koivu,646,587,1233,74,2,0.5239253852392538,49.0,24.0
20112012,Mike Santorelli,176,213,389,60,2,0.4524421593830334,136.0,115.0
20112012,Jamie Benn,347,404,751,71,2,0.4620505992010652,126.0,72.0
20112012,Andrew Desjardins,192,170,362,76,2,0.5303867403314917,41.0,111.0
20112012,John Madden,27,40,67,7,3,0.40298507462686567,65.0,48.0
20112012,Zack Smith,36,31,67,7,3,0.5373134328358209,22.0,41.0
20112012,Jordan Staal,52,53,105,6,3,0.49523809523809526,39.0,32.0
20112012,Henrik Zetterberg,36,43,79,5,3,0.45569620253164556,49.0,41.0
20112012,Zenon Konopka,53,22,75,6,3,0.7066666666666667,2.0,31.0
20112012,Pavel Datsyuk,66,52,118,5,3,0.559322033898305,17.0,26.0
20112012,Vladimir Sobotka,48,32,80,9,3,0.6,10.0,34.0
20112012,Patrik Berglund,54,89,143,9,3,0.3776223776223776,71.0,30.0
20112012,Patrick Kane,10,26,36,6,3,0.2777777777777778,75.0,60.0
20112012,Patrice Bergeron,73,50,123,7,3,0.5934959349593496,11.0,23.0
20112012,Brad Richards,217,220,437,20,3,0.4965675057208238,38.0,2.0
20112012,Scott Nichol,46,28,74,9,3,0.6216216216216216,5.0,35.0
20112012,Matt Hendricks,65,51,116,14,3,0.5603448275862069,16.0,27.0
20112012,Matt Read,28,52,80,11,3,0.35,73.0,47.0
20112012,Martin Hanzal,63,84,147,12,3,0.42857142857142855,60.0,28.0
20112012,Stephen Gionta,34,55,89,24,3,0.38202247191011235,70.0,42.0
20112012,Antoine Vermette,169,119,288,16,3,0.5868055555555556,13.0,6.0
20112012,Jarret Stoll,172,160,332,20,3,0.5180722891566265,30.0,5.0
20112012,Sidney Crosby,74,61,135,6,3,0.5481481481481482,18.0,22.0
20112012,Marcus Kruger,25,24,49,6,3,0.5102040816326531,33.0,49.0
20112012,David Clarkson,15,25,40,24,3,0.375,72.0,57.0
20112012,Artem Anisimov,30,37,67,20,3,0.44776119402985076,51.0,45.0
20112012,Brayden Schenn,32,42,74,11,3,0.43243243243243246,58.0,44.0
20112012,Jason Spezza,63,53,116,7,3,0.5431034482758621,19.0,28.0
20112012,Justin Abdelkader,24,25,49,5,3,0.4897959183673469,40.0,50.0
20112012,Jeff Carter,30,27,57,20,3,0.5263157894736842,27.0,45.0
20112012,Keith Aucoin,22,33,55,14,3,0.4,66.0,52.0
20112012,Brandon Dubinsky,23,22,45,9,3,0.5111111111111111,32.0,51.0
20112012,Logan Couture,20,26,46,5,3,0.43478260869565216,56.0,54.0
20112012,Brian Boyle,149,158,307,17,3,0.48534201954397393,42.0,8.0
20112012,Adam Henrique,148,191,339,24,3,0.4365781710914454,55.0,9.0
20112012,Mathieu Perreault,16,16,32,4,3,0.5,35.0,56.0
20112012,Derek Stepan,103,131,234,20,3,0.44017094017094016,54.0,14.0
20112012,Jacob Josefson,41,37,78,6,3,0.5256410256410257,28.0,39.0
20112012,Paul Gaustad,95,63,158,10,3,0.6012658227848101,9.0,15.0
20112012,Dominic Moore,16,16,32,3,3,0.5,35.0,56.0
20112012,Henrik Sedin,30,46,76,5,3,0.39473684210526316,68.0,45.0
20112012,Brooks Laich,113,120,233,14,3,0.48497854077253216,43.0,13.0
20112012,Jonathan Toews,80,43,123,6,3,0.6504065040650406,3.0,20.0
20112012,Rich Peverley,34,37,71,7,3,0.4788732394366197,45.0,42.0
20112012,Travis Zajac,243,205,448,24,3,0.5424107142857143,20.0,1.0
20112012,David Krejci,51,64,115,7,3,0.4434782608695652,52.0,33.0
20112012,Sean Couturier,67,59,126,11,3,0.5317460317460317,24.0,25.0
20112012,Mike Fisher,85,104,189,10,3,0.4497354497354497,50.0,18.0
20112012,Chris Kelly,43,40,83,7,3,0.5180722891566265,30.0,37.0
20112012,Evgeni Malkin,48,43,91,6,3,0.5274725274725275,26.0,34.0
20112012,Daniel Bri√®re,79,50,129,11,3,0.6124031007751938,6.0,21.0
20112012,Jay Beagle,87,74,161,12,3,0.5403726708074534,21.0,17.0
20112012,Kyle Turris,27,41,68,7,3,0.39705882352941174,67.0,48.0
20112012,Stephen Weiss,65,61,126,7,3,0.5158730158730159,31.0,27.0
20112012,David Legwand,66,66,132,10,3,0.5,35.0,26.0
20112012,Andrew Desjardins,21,14,35,5,3,0.6,10.0,53.0
20112012,Ray Whitney,11,21,32,16,3,0.34375,74.0,59.0
20112012,Max Talbot,13,18,31,11,3,0.41935483870967744,62.0,58.0
20112012,Anze Kopitar,179,189,368,20,3,0.48641304347826086,41.0,4.0
20112012,Jim O'Brien,15,16,31,7,3,0.4838709677419355,44.0,57.0
20112012,Jerred Smithson,28,10,38,5,3,0.7368421052631579,1.0,47.0
20112012,Joe Thornton,44,28,72,5,3,0.6111111111111112,7.0,36.0
20112012,David Backes,89,65,154,9,3,0.577922077922078,15.0,16.0
20112012,Mike Richards,168,169,337,20,3,0.49851632047477745,36.0,7.0
20112012,Boyd Gordon,182,125,307,16,3,0.5928338762214984,12.0,3.0
20112012,Colin Fraser,38,50,88,18,3,0.4318181818181818,59.0,40.0
20112012,Daymond Langkow,81,115,196,16,3,0.413265306122449,64.0,19.0
20112012,Samuel Pahlsson,19,21,40,5,3,0.475,46.0,55.0
20112012,Jason Arnott,16,25,41,7,3,0.3902439024390244,69.0,56.0
20112012,Patrik Elias,135,183,318,24,3,0.42452830188679247,61.0,10.0
20112012,Ryan Kesler,60,53,113,5,3,0.5309734513274337,25.0,29.0
20112012,Joe Pavelski,33,43,76,5,3,0.4342105263157895,57.0,43.0
20112012,Andy McDonald,33,24,57,9,3,0.5789473684210527,14.0,43.0
20112012,Nick Spaling,46,53,99,10,3,0.46464646464646464,47.0,35.0
20112012,Manny Malhotra,42,23,65,5,3,0.6461538461538462,4.0,38.0
20112012,Dainius Zubrus,29,28,57,24,3,0.5087719298245614,34.0,46.0
20112012,Nicklas Backstrom,116,117,233,13,3,0.4978540772532189,37.0,12.0
20112012,Claude Giroux,123,114,237,10,3,0.5189873417721519,29.0,11.0
20112012,Dave Bolland,46,58,104,6,3,0.4423076923076923,53.0,35.0
20112012,Gregory Campbell,24,34,58,7,3,0.41379310344827586,63.0,50.0
20112012,John Mitchell,38,33,71,18,3,0.5352112676056338,23.0,40.0
20112012,Marcel Goc,68,45,113,7,3,0.6017699115044248,8.0,24.0
20112012,Patrick Marleau,22,26,48,5,3,0.4583333333333333,48.0,52.0
20122013,Zack Smith,379,352,731,48,2,0.518467852257182,53.0,30.0
20122013,Jussi Jokinen,250,182,432,43,2,0.5787037037037037,12.0,59.0
20122013,Drew Shore,212,231,443,43,2,0.4785553047404063,101.0,72.0
20122013,Riley Nash,128,161,289,32,2,0.4429065743944637,132.0,105.0
20122013,Derek MacKenzie,192,131,323,43,2,0.5944272445820433,7.0,81.0
20122013,Craig Smith,79,121,200,44,2,0.395,149.0,127.0
20122013,Ryan O'Reilly,241,215,456,29,2,0.5285087719298246,44.0,64.0
20122013,Henrik Zetterberg,263,281,544,46,2,0.4834558823529412,93.0,55.0
20122013,Pavel Datsyuk,488,399,887,47,2,0.5501691093573844,31.0,7.0
20122013,Casey Cizikas,144,132,276,45,2,0.5217391304347826,50.0,98.0
20122013,Vladimir Sobotka,286,220,506,48,2,0.5652173913043478,18.0,47.0
20122013,Ryan Nugent-Hopkins,226,325,551,40,2,0.4101633393829401,146.0,68.0
20122013,Nik Antropov,128,176,304,40,2,0.42105263157894735,143.0,105.0
20122013,Lars Eller,267,275,542,46,2,0.492619926199262,84.0,53.0
20122013,Patrik Berglund,279,324,603,48,2,0.4626865671641791,117.0,48.0
20122013,David Desharnais,382,382,764,48,2,0.5,76.0,28.0
20122013,Nate Thompson,310,295,605,45,2,0.512396694214876,63.0,42.0
20122013,Steve Ott,298,237,535,48,2,0.5570093457943925,26.0,45.0
20122013,Shawn Horcoff,245,255,500,31,2,0.49,86.0,61.0
20122013,Kevin Porter,109,162,271,31,2,0.4022140221402214,147.0,112.0
20122013,Patrice Bergeron,549,335,884,42,2,0.6210407239819005,1.0,3.0
20122013,Sam Gagner,325,416,741,48,2,0.43859649122807015,137.0,39.0
20122013,Kyle Chipchura,126,135,261,46,2,0.4827586206896552,95.0,106.0
20122013,Brad Richards,391,382,773,46,2,0.5058214747736093,69.0,27.0
20122013,Scott Nichol,132,86,218,30,2,0.6055045871559633,4.0,104.0
20122013,Matt Hendricks,147,112,259,48,2,0.5675675675675675,17.0,96.0
20122013,Matt Cullen,245,203,448,42,2,0.546875,32.0,61.0
20122013,Ryan Smyth,87,115,202,47,2,0.4306930693069307,142.0,124.0
20122013,Martin Hanzal,298,339,637,39,2,0.46781789638932497,112.0,45.0
20122013,Stephen Gionta,137,253,390,48,2,0.35128205128205126,153.0,103.0
20122013,Joakim Andersson,144,166,310,38,2,0.4645161290322581,114.0,98.0
20122013,Antoine Vermette,482,357,839,48,2,0.5744934445768772,13.0,9.0
20122013,Sidney Crosby,453,381,834,36,2,0.5431654676258992,38.0,14.0
20122013,David Steckel,175,146,321,34,2,0.5451713395638629,34.0,86.0
20122013,Matt Duchene,488,405,893,47,2,0.5464725643896976,33.0,7.0
20122013,Steven Stamkos,406,413,819,48,2,0.49572649572649574,80.0,25.0
20122013,Kyle Okposo,104,82,186,48,2,0.5591397849462365,24.0,115.0
20122013,Frans Nielsen,268,290,558,48,2,0.48028673835125446,98.0,52.0
20122013,Mike Ribeiro,226,279,505,48,2,0.44752475247524753,130.0,68.0
20122013,Andrei Loktionov,80,126,206,28,2,0.3883495145631068,151.0,126.0
20122013,Alex Tanguay,68,105,173,40,2,0.3930635838150289,150.0,130.0
20122013,Derek Roy,295,352,647,42,2,0.4559505409582689,126.0,46.0
20122013,Jim Slater,145,122,267,26,2,0.5430711610486891,39.0,97.0
20122013,Jeff Carter,202,182,384,48,2,0.5260416666666666,45.0,77.0
20122013,Michal Handzus,236,190,426,39,2,0.5539906103286385,29.0,66.0
20122013,Bryan Little,431,411,842,48,2,0.5118764845605701,64.0,21.0
20122013,Marty Reasoner,157,142,299,31,2,0.5250836120401338,47.0,94.0
20122013,Matt Stajan,356,414,770,43,2,0.4623376623376623,120.0,34.0
20122013,Tyler Ennis,158,219,377,47,2,0.41909814323607425,144.0,93.0
20122013,Alexander Steen,94,110,204,40,2,0.46078431372549017,123.0,119.0
20122013,Chris Kelly,216,157,373,34,2,0.579088471849866,11.0,70.0
20122013,Patrik Elias,71,92,163,48,2,0.43558282208588955,141.0,129.0
20122013,Brandon Dubinsky,256,183,439,29,2,0.5831435079726651,10.0,56.0
20122013,Shawn Matthias,153,194,347,48,2,0.4409221902017291,134.0,95.0
20122013,Marcus Kruger,228,265,493,47,2,0.46247464503042596,119.0,67.0
20122013,Joe Vitale,157,100,257,33,2,0.6108949416342413,2.0,94.0
20122013,Ryan Getzlaf,355,384,739,44,2,0.4803788903924222,97.0,35.0
20122013,Henrik Sedin,440,451,891,48,2,0.49382716049382713,82.0,18.0
20122013,Kyle Brodziak,377,386,763,48,2,0.4941022280471822,81.0,31.0
20122013,Paul Stastny,409,372,781,40,2,0.5236875800256082,48.0,24.0
20122013,Jay Beagle,249,195,444,48,2,0.5608108108108109,21.0,60.0
20122013,Mike Fisher,275,288,563,38,2,0.48845470692717585,90.0,49.0
20122013,Max Talbot,92,100,192,35,2,0.4791666666666667,100.0,121.0
20122013,Joe Thornton,410,291,701,48,2,0.5848787446504993,8.0,23.0
20122013,Anze Kopitar,473,415,888,47,2,0.5326576576576577,43.0,11.0
20122013,Jarret Stoll,418,328,746,48,2,0.5603217158176944,23.0,22.0
20122013,Jerred Smithson,265,213,478,45,2,0.5543933054393305,27.0,54.0
20122013,Jochen Hecht,147,206,353,47,2,0.4164305949008499,145.0,96.0
20122013,Logan Couture,252,237,489,48,2,0.5153374233128835,59.0,58.0
20122013,Tyler Bozak,559,504,1063,46,2,0.5258701787394168,46.0,2.0
20122013,Valtteri Filppula,179,144,323,41,2,0.5541795665634675,28.0,85.0
20122013,Paul Gaustad,268,181,449,23,2,0.5968819599109132,6.0,52.0
20122013,Brian Boyle,215,166,381,38,2,0.5643044619422573,19.0,71.0
20122013,Cory Emmerton,187,226,413,48,2,0.45278450363196127,129.0,83.0
20122013,Alexander Burmistrov,142,159,301,44,2,0.4717607973421927,107.0,99.0
20122013,Eric Staal,527,487,1014,48,2,0.519723865877712,52.0,4.0
20122013,Mike Richards,216,225,441,48,2,0.4897959183673469,87.0,70.0
20122013,Artem Anisimov,249,260,509,35,2,0.48919449901768175,89.0,60.0
20122013,Brandon Sutter,382,379,761,48,2,0.5019710906701709,73.0,28.0
20122013,Mikael Backlund,194,213,407,32,2,0.47665847665847666,103.0,80.0
20122013,Brayden Schenn,206,247,453,47,2,0.45474613686534215,127.0,75.0
20122013,Derek Stepan,448,529,977,48,2,0.458546571136131,124.0,17.0
20122013,Vernon Fiddler,319,300,619,46,2,0.5153473344103393,58.0,41.0
20122013,John Mitchell,171,173,344,47,2,0.49709302325581395,79.0,88.0
20122013,Jacob Josefson,114,122,236,22,2,0.4830508474576271,94.0,110.0
20122013,Andrew Ebbett,106,161,267,28,2,0.3970037453183521,148.0,113.0
20122013,Peter Holland,89,114,203,21,2,0.43842364532019706,138.0,123.0
20122013,Tomas Plekanec,486,475,961,47,2,0.5057232049947971,70.0,8.0
20122013,Evgeni Malkin,195,218,413,31,2,0.4721549636803874,106.0,79.0
20122013,Dustin Jeffrey,94,106,200,24,2,0.47,110.0,119.0
20122013,Keith Aucoin,167,177,344,41,2,0.48546511627906974,92.0,90.0
20122013,Eric Belanger,203,175,378,26,2,0.5370370370370371,41.0,76.0
20122013,Jim O'Brien,100,119,219,29,2,0.45662100456621,125.0,116.0
20122013,Jordan Staal,458,456,914,48,2,0.5010940919037199,74.0,13.0
20122013,Ryan White,91,76,167,26,2,0.5449101796407185,35.0,122.0
20122013,Vincent Lecavalier,404,338,742,39,2,0.5444743935309974,37.0,26.0
20122013,Tim Brent,124,116,240,30,2,0.5166666666666667,56.0,107.0
20122013,Jordan Schroeder,140,181,321,31,2,0.43613707165109034,140.0,101.0
20122013,Adam Henrique,333,347,680,42,2,0.48970588235294116,88.0,37.0
20122013,Mathieu Perreault,168,157,325,39,2,0.5169230769230769,55.0,89.0
20122013,Tom Pyatt,145,145,290,43,2,0.5,76.0,97.0
20122013,David Backes,477,435,912,48,2,0.5230263157894737,49.0,10.0
20122013,John Tavares,459,471,930,48,2,0.4935483870967742,83.0,12.0
20122013,Mikhail Grabovski,323,315,638,48,2,0.5062695924764891,67.0,40.0
20122013,Ryan Kesler,174,129,303,17,2,0.5742574257425742,15.0,87.0
20122013,Andrew Shaw,201,256,457,48,2,0.43982494529540483,135.0,78.0
20122013,Andy McDonald,95,103,198,37,2,0.4797979797979798,99.0,118.0
20122013,Joe Pavelski,342,318,660,48,2,0.5181818181818182,54.0,36.0
20122013,Adam Hall,141,110,251,37,2,0.5617529880478087,20.0,100.0
20122013,Claude Giroux,644,538,1182,48,2,0.544839255499154,36.0,1.0
20122013,Dave Bolland,239,279,518,35,2,0.4613899613899614,121.0,65.0
20122013,Troy Brouwer,111,121,232,47,2,0.47844827586206895,102.0,111.0
20122013,Patrick Marleau,71,79,150,48,2,0.47333333333333333,105.0,129.0
20122013,Gregory Campbell,189,212,401,48,2,0.4713216957605985,108.0,82.0
20122013,Michael Cammalleri,253,243,496,44,2,0.5100806451612904,66.0,57.0
20122013,Marcel Goc,410,376,786,42,2,0.5216284987277354,51.0,23.0
20122013,Jay McClement,203,190,393,48,2,0.5165394402035624,57.0,76.0
20122013,Matthew Lombardi,105,131,236,28,2,0.4449152542372881,131.0,114.0
20122013,Teemu Selanne,85,83,168,46,2,0.5059523809523809,68.0,125.0
20122013,Adam Burish,122,106,228,46,2,0.5350877192982456,42.0,109.0
20122013,Jonathan Toews,559,374,933,47,2,0.5991425509110396,5.0,2.0
20122013,Rich Peverley,211,150,361,47,2,0.5844875346260388,9.0,73.0
20122013,Mikael Granlund,97,109,206,27,2,0.470873786407767,109.0,117.0
20122013,Maxim Lapierre,274,268,542,48,2,0.5055350553505535,71.0,50.0
20122013,Ryan Johansen,272,257,529,40,2,0.5141776937618148,61.0,51.0
20122013,Travis Zajac,506,375,881,48,2,0.5743473325766175,14.0,6.0
20122013,David Krejci,361,293,654,47,2,0.5519877675840978,30.0,33.0
20122013,Cody Eakin,304,322,626,48,2,0.48562300319488816,91.0,43.0
20122013,Sean Couturier,243,310,553,46,2,0.4394213381555154,136.0,63.0
20122013,Mark Letestu,244,243,487,46,2,0.5010266940451745,75.0,62.0
20122013,Scott Gomez,181,143,324,39,2,0.558641975308642,25.0,84.0
20122013,Nick Spaling,223,259,482,47,2,0.46265560165975106,118.0,69.0
20122013,Mika Zibanejad,159,184,343,42,2,0.46355685131195334,116.0,92.0
20122013,Zenon Konopka,162,105,267,37,2,0.6067415730337079,3.0,91.0
20122013,Mikko Koivu,524,447,971,48,2,0.5396498455200824,40.0,5.0
20122013,Nicklas Backstrom,432,408,840,48,2,0.5142857142857142,60.0,20.0
20122013,Kyle Turris,451,469,920,48,2,0.4902173913043478,85.0,16.0
20122013,Stephen Weiss,141,135,276,17,2,0.5108695652173914,65.0,100.0
20122013,Roman Horak,93,112,205,20,2,0.45365853658536587,128.0,120.0
20122013,Nazem Kadri,250,315,565,48,2,0.4424778761061947,133.0,59.0
20122013,David Legwand,362,359,721,48,2,0.5020804438280166,72.0,32.0
20122013,Olli Jokinen,300,330,630,45,2,0.47619047619047616,104.0,44.0
20122013,Saku Koivu,437,414,851,47,2,0.5135135135135135,62.0,19.0
20122013,Jamie Benn,327,382,709,41,2,0.461212976022567,122.0,38.0
20122013,Peter Regin,92,118,210,27,2,0.4380952380952381,139.0,121.0
20122013,Ruslan Fedotenko,67,119,186,47,2,0.3602150537634409,152.0,131.0
20122013,Boyd Gordon,452,337,789,48,2,0.5728770595690748,16.0,15.0
20122013,Chris Mueller,92,93,185,18,2,0.4972972972972973,78.0,121.0
20122013,Derick Brassard,215,231,446,47,2,0.4820627802690583,96.0,71.0
20122013,Colin Fraser,78,90,168,34,2,0.4642857142857143,115.0,128.0
20122013,Cody Hodgson,380,432,812,48,2,0.46798029556650245,111.0,29.0
20122013,Jarome Iginla,123,124,247,44,2,0.4979757085020243,77.0,108.0
20122013,Jeff Halpern,208,163,371,46,2,0.5606469002695418,22.0,74.0
20122013,Nick Bonino,138,157,295,27,2,0.46779661016949153,113.0,102.0
20122013,Zack Smith,68,65,133,10,3,0.5112781954887218,33.0,27.0
20122013,Derek Roy,17,32,49,4,3,0.3469387755102041,69.0,56.0
20122013,Michal Handzus,156,180,336,23,3,0.4642857142857143,53.0,6.0
20122013,Henrik Zetterberg,62,67,129,14,3,0.4806201550387597,46.0,31.0
20122013,Vladimir Sobotka,43,34,77,6,3,0.5584415584415584,13.0,42.0
20122013,Derick Brassard,82,82,164,12,3,0.5,39.0,20.0
20122013,Patrik Berglund,35,53,88,6,3,0.3977272727272727,64.0,47.0
20122013,David Desharnais,34,36,70,5,3,0.4857142857142857,42.0,48.0
20122013,Patrice Bergeron,304,190,494,22,3,0.6153846153846154,3.0,1.0
20122013,Casey Cizikas,26,26,52,6,3,0.5,39.0,52.0
20122013,Pavel Datsyuk,181,144,325,14,3,0.556923076923077,14.0,3.0
20122013,Brad Richards,46,50,96,10,3,0.4791666666666667,48.0,40.0
20122013,Matt Hendricks,12,18,30,7,3,0.4,63.0,58.0
20122013,Matt Cullen,55,38,93,5,3,0.5913978494623656,7.0,34.0
20122013,Sidney Crosby,172,172,344,14,3,0.5,39.0,5.0
20122013,Kyle Okposo,19,17,36,6,3,0.5277777777777778,26.0,54.0
20122013,Marcus Kruger,71,118,189,23,3,0.37566137566137564,67.0,25.0
20122013,Milan Lucic,18,16,34,22,3,0.5294117647058824,25.0,55.0
20122013,Jarret Stoll,97,93,190,12,3,0.5105263157894737,34.0,16.0
20122013,Frans Nielsen,34,42,76,6,3,0.4473684210526316,60.0,48.0
20122013,Joakim Andersson,99,78,177,14,3,0.559322033898305,12.0,15.0
20122013,Mike Ribeiro,60,56,116,7,3,0.5172413793103449,31.0,33.0
20122013,Brandon Sutter,126,123,249,15,3,0.5060240963855421,35.0,9.0
20122013,Jason Spezza,33,31,64,3,3,0.515625,32.0,49.0
20122013,Joe Vitale,30,21,51,6,3,0.5882352941176471,9.0,51.0
20122013,Jeff Carter,77,91,168,18,3,0.4583333333333333,55.0,22.0
20122013,David Steckel,38,32,70,7,3,0.5428571428571428,20.0,46.0
20122013,Craig Adams,16,26,42,15,3,0.38095238095238093,66.0,57.0
20122013,Ryan Getzlaf,39,78,117,7,3,0.3333333333333333,70.0,45.0
20122013,Henrik Sedin,41,47,88,4,3,0.4659090909090909,52.0,43.0
20122013,Kyle Brodziak,47,50,97,5,3,0.4845360824742268,43.0,39.0
20122013,Logan Couture,76,50,126,11,3,0.6031746031746031,5.0,23.0
20122013,Tyler Bozak,63,85,148,5,3,0.42567567567567566,61.0,30.0
20122013,Valtteri Filppula,76,63,139,14,3,0.5467625899280576,18.0,23.0
20122013,Brian Boyle,91,98,189,11,3,0.48148148148148145,45.0,17.0
20122013,Cory Emmerton,40,45,85,13,3,0.47058823529411764,50.0,44.0
20122013,Derek Stepan,118,127,245,12,3,0.4816326530612245,44.0,13.0
20122013,Tomas Plekanec,70,55,125,5,3,0.56,11.0,26.0
20122013,Mathieu Perreault,47,40,87,7,3,0.5402298850574713,21.0,39.0
20122013,Jonathan Toews,268,237,505,23,3,0.5306930693069307,24.0,2.0
20122013,Rich Peverley,119,70,189,21,3,0.6296296296296297,2.0,12.0
20122013,David Krejci,149,181,330,22,3,0.45151515151515154,57.0,7.0
20122013,Kyle Turris,120,97,217,10,3,0.5529953917050692,17.0,11.0
20122013,Patrick Sharp,32,28,60,23,3,0.5333333333333333,23.0,50.0
20122013,Nazem Kadri,18,39,57,7,3,0.3157894736842105,71.0,55.0
20122013,Jussi Jokinen,46,29,75,8,3,0.6133333333333333,4.0,40.0
20122013,Saku Koivu,72,65,137,7,3,0.5255474452554745,27.0,24.0
20122013,Andrew Desjardins,16,19,35,11,3,0.45714285714285713,56.0,57.0
20122013,Chris Kelly,138,110,248,22,3,0.5564516129032258,15.0,8.0
20122013,Evgeni Malkin,79,90,169,15,3,0.46745562130177515,51.0,21.0
20122013,Trevor Lewis,33,50,83,18,3,0.39759036144578314,65.0,49.0
20122013,Jean-Gabriel Pageau,64,67,131,10,3,0.48854961832061067,40.0,29.0
20122013,Scott Gomez,48,52,100,9,3,0.48,47.0,38.0
20122013,Mika Zibanejad,32,55,87,10,3,0.367816091954023,68.0,50.0
20122013,Mikko Koivu,50,46,96,5,3,0.5208333333333334,29.0,37.0
20122013,Nicklas Backstrom,66,55,121,7,3,0.5454545454545454,19.0,28.0
20122013,Mike Richards,102,101,203,15,3,0.5024630541871922,38.0,14.0
20122013,Joe Thornton,121,91,212,11,3,0.5707547169811321,10.0,10.0
20122013,Anze Kopitar,174,161,335,18,3,0.5194029850746269,30.0,4.0
20122013,Keith Aucoin,26,18,44,6,3,0.5909090909090909,8.0,52.0
20122013,David Backes,72,48,120,6,3,0.6,6.0,24.0
20122013,John Tavares,61,60,121,6,3,0.5041322314049587,37.0,32.0
20122013,Mikhail Grabovski,44,54,98,7,3,0.4489795918367347,59.0,41.0
20122013,Jeff Halpern,21,22,43,3,3,0.4883720930232558,41.0,53.0
20122013,Ryan Kesler,54,49,103,4,3,0.5242718446601942,28.0,35.0
20122013,Andrew Shaw,85,95,180,23,3,0.4722222222222222,49.0,19.0
20122013,Andy McDonald,21,9,30,6,3,0.7,1.0,53.0
20122013,Joe Pavelski,90,77,167,11,3,0.5389221556886228,22.0,18.0
20122013,Colin Fraser,32,37,69,16,3,0.463768115942029,54.0,50.0
20122013,Nick Bonino,55,44,99,7,3,0.5555555555555556,16.0,34.0
20122013,Dave Bolland,85,115,200,18,3,0.425,62.0,19.0
20122013,Jay McClement,46,56,102,7,3,0.45098039215686275,58.0,40.0
20122013,Gregory Campbell,52,51,103,15,3,0.5048543689320388,36.0,36.0
20132014,Tyler Johnson,614,661,1275,82,2,0.4815686274509804,118.0,34.0
20132014,Zack Smith,680,611,1291,82,2,0.5267234701781565,51.0,23.0
20132014,Drew Shore,86,122,208,24,2,0.41346153846153844,182.0,152.0
20132014,Will Acton,98,97,195,30,2,0.5025641025641026,88.0,144.0
20132014,Riley Nash,306,360,666,73,2,0.4594594594594595,147.0,86.0
20132014,Derek MacKenzie,256,241,497,71,2,0.5150905432595574,68.0,97.0
20132014,Michal Handzus,329,335,664,59,2,0.4954819277108434,93.0,84.0
20132014,Mark Arcobello,206,198,404,41,2,0.5099009900990099,74.0,108.0
20132014,Erik Haula,161,187,348,46,2,0.46264367816091956,140.0,125.0
20132014,Johan Larsson,135,150,285,28,2,0.47368421052631576,132.0,131.0
20132014,Marcel Goc,658,575,1233,74,2,0.5336577453365775,37.0,27.0
20132014,Ryan O'Reilly,192,179,371,80,2,0.5175202156334232,64.0,115.0
20132014,Henrik Zetterberg,259,230,489,45,2,0.5296523517382413,41.0,96.0
20132014,Drew Stafford,106,91,197,70,2,0.5380710659898477,33.0,140.0
20132014,Pavel Datsyuk,446,389,835,45,2,0.5341317365269461,36.0,66.0
20132014,Casey Cizikas,489,522,1011,80,2,0.4836795252225519,116.0,60.0
20132014,Vladimir Sobotka,503,310,813,61,2,0.6186961869618696,2.0,57.0
20132014,Darren Helm,269,279,548,42,2,0.4908759124087591,98.0,93.0
20132014,Ryan Nugent-Hopkins,543,737,1280,80,2,0.42421875,172.0,47.0
20132014,Vincent Lecavalier,200,248,448,69,2,0.44642857142857145,158.0,111.0
20132014,Derick Brassard,469,508,977,81,2,0.48004094165813715,120.0,63.0
20132014,Lars Eller,521,458,979,77,2,0.5321756894790602,39.0,53.0
20132014,Patrik Berglund,373,410,783,78,2,0.4763729246487867,128.0,75.0
20132014,Mike Ribeiro,391,512,903,80,2,0.4330011074197121,167.0,73.0
20132014,David Desharnais,611,591,1202,79,2,0.5083194675540765,77.0,36.0
20132014,Nate Thompson,496,478,974,81,2,0.5092402464065708,76.0,58.0
20132014,Brian Flynn,184,205,389,79,2,0.4730077120822622,133.0,117.0
20132014,Andrei Loktionov,154,215,369,68,2,0.4173441734417344,178.0,127.0
20132014,Eric Fehr,196,230,426,73,2,0.460093896713615,146.0,113.0
20132014,Mikhail Grabovski,346,295,641,58,2,0.5397815912636506,29.0,80.0
20132014,Patrice Bergeron,1015,717,1732,80,2,0.586027713625866,7.0,1.0
20132014,Sam Gagner,451,512,963,67,2,0.4683281412253375,136.0,65.0
20132014,Kyle Chipchura,176,155,331,80,2,0.5317220543806647,40.0,120.0
20132014,Elias Lindholm,106,123,229,58,2,0.462882096069869,139.0,140.0
20132014,Brad Richards,512,517,1029,82,2,0.4975704567541302,91.0,55.0
20132014,Boyd Gordon,843,649,1492,74,2,0.5650134048257373,14.0,6.0
20132014,Charlie Coyle,192,266,458,70,2,0.4192139737991266,177.0,115.0
20132014,Brock Nelson,191,260,451,72,2,0.42350332594235035,174.0,116.0
20132014,Aleksander Barkov,400,419,819,54,2,0.4884004884004884,107.0,72.0
20132014,James Wright,126,143,269,59,2,0.4684014869888476,135.0,133.0
20132014,Jerred Smithson,126,90,216,18,2,0.5833333333333334,8.0,133.0
20132014,Luke Glendening,329,349,678,56,2,0.48525073746312686,112.0,84.0
20132014,Jordan Schroeder,112,132,244,25,2,0.45901639344262296,148.0,139.0
20132014,Adam Henrique,407,511,918,77,2,0.4433551198257081,162.0,71.0
20132014,Paul Stastny,655,555,1210,71,2,0.5413223140495868,28.0,28.0
20132014,Shawn Horcoff,209,208,417,77,2,0.5011990407673861,89.0,107.0
20132014,Marc-Andre Cliche,331,388,719,76,2,0.4603616133518776,144.0,83.0
20132014,Derek Roy,219,247,466,75,2,0.4699570815450644,134.0,103.0
20132014,Kyle Okposo,97,107,204,71,2,0.47549019607843135,129.0,145.0
20132014,Derek Grant,79,71,150,20,2,0.5266666666666666,53.0,155.0
20132014,Daniel Bri√®re,171,179,350,69,2,0.48857142857142855,106.0,121.0
20132014,Frans Nielsen,534,550,1084,80,2,0.492619926199262,96.0,49.0
20132014,Colin Wilson,166,177,343,81,2,0.4839650145772595,115.0,122.0
20132014,Matt Cullen,438,334,772,77,2,0.5673575129533679,12.0,67.0
20132014,Anton Lander,71,89,160,27,2,0.44375,161.0,158.0
20132014,Joe Vitale,200,120,320,53,2,0.625,1.0,111.0
20132014,Logan Couture,479,471,950,65,2,0.5042105263157894,85.0,61.0
20132014,Tyler Bozak,681,718,1399,58,2,0.4867762687634024,110.0,22.0
20132014,Paul Gaustad,696,504,1200,75,2,0.58,10.0,18.0
20132014,Brian Boyle,306,272,578,82,2,0.5294117647058824,42.0,86.0
20132014,Eric Staal,754,676,1430,79,2,0.5272727272727272,49.0,13.0
20132014,Joe Colborne,214,227,441,80,2,0.4852607709750567,111.0,106.0
20132014,Maxim Lapierre,301,292,593,71,2,0.5075885328836425,80.0,88.0
20132014,Ryan Smyth,91,91,182,72,2,0.5,90.0,147.0
20132014,Brandon Dubinsky,586,521,1107,76,2,0.5293586269196026,43.0,40.0
20132014,Marcus Kruger,438,335,773,81,2,0.5666235446313066,13.0,67.0
20132014,Marcus Johansson,95,179,274,80,2,0.3467153284671533,188.0,146.0
20132014,Jason Spezza,775,661,1436,75,2,0.5396935933147632,30.0,10.0
20132014,Ville Leino,125,162,287,58,2,0.4355400696864111,165.0,134.0
20132014,Derek Stepan,683,829,1512,82,2,0.45171957671957674,153.0,21.0
20132014,Vernon Fiddler,513,469,982,76,2,0.5224032586558045,61.0,54.0
20132014,John Mitchell,374,374,748,75,2,0.5,90.0,74.0
20132014,Jacob Josefson,83,85,168,27,2,0.49404761904761907,94.0,154.0
20132014,Tomas Plekanec,822,891,1713,81,2,0.4798598949211909,121.0,7.0
20132014,Zac Dalpe,106,125,231,55,2,0.4588744588744589,149.0,140.0
20132014,Martin Hanzal,599,500,1099,65,2,0.5450409463148317,26.0,37.0
20132014,Jarret Stoll,678,561,1239,78,2,0.5472154963680388,21.0,24.0
20132014,Brandon Sutter,549,601,1150,81,2,0.47739130434782606,126.0,46.0
20132014,Zemgus Girgensons,100,140,240,70,2,0.4166666666666667,179.0,143.0
20132014,Mikael Backlund,628,694,1322,76,2,0.4750378214826021,130.0,30.0
20132014,Brayden Schenn,296,389,685,82,2,0.4321167883211679,169.0,89.0
20132014,Ryan Getzlaf,692,719,1411,77,2,0.49043231750531535,100.0,20.0
20132014,Henrik Sedin,574,523,1097,70,2,0.5232452142206017,59.0,43.0
20132014,Mark Scheifele,331,454,785,63,2,0.42165605095541403,176.0,83.0
20132014,Kyle Brodziak,590,633,1223,81,2,0.48242027800490594,117.0,39.0
20132014,Mike Santorelli,215,204,419,49,2,0.513126491646778,70.0,105.0
20132014,Johan Franzen,119,106,225,54,2,0.5288888888888889,46.0,135.0
20132014,Zenon Konopka,345,222,567,59,2,0.6084656084656085,3.0,81.0
20132014,Rickard Rakell,95,99,194,18,2,0.4896907216494845,103.0,146.0
20132014,Stephen Gionta,238,343,581,66,2,0.40963855421686746,183.0,101.0
20132014,Joakim Andersson,345,326,671,65,2,0.5141579731743666,69.0,81.0
20132014,Antoine Vermette,1005,778,1783,82,2,0.5636567582725743,15.0,2.0
20132014,Sidney Crosby,991,896,1887,80,2,0.525172231054584,57.0,3.0
20132014,Matt Duchene,532,526,1058,71,2,0.502835538752363,87.0,51.0
20132014,Steven Stamkos,260,269,529,37,2,0.4914933837429111,97.0,95.0
20132014,Nick Bjugstad,549,574,1123,76,2,0.4888691006233304,104.0,46.0
20132014,Jordan Staal,803,674,1477,82,2,0.5436696005416385,27.0,8.0
20132014,Ben Smith,200,194,394,75,2,0.5076142131979695,79.0,111.0
20132014,Stephen Weiss,184,173,357,26,2,0.5154061624649859,67.0,117.0
20132014,Ryan White,197,191,388,52,2,0.5077319587628866,78.0,112.0
20132014,Marcus Foligno,146,155,301,74,2,0.4850498338870432,113.0,129.0
20132014,Jim Slater,163,118,281,27,2,0.5800711743772242,9.0,124.0
20132014,Eric O'Dell,78,78,156,30,2,0.5,90.0,156.0
20132014,Jeff Carter,336,308,644,72,2,0.5217391304347826,62.0,82.0
20132014,Bryan Little,785,868,1653,82,2,0.4748941318814277,131.0,9.0
20132014,Matt Stajan,527,569,1096,63,2,0.48083941605839414,119.0,52.0
20132014,Jean-Gabriel Pageau,118,128,246,28,2,0.4796747967479675,122.0,136.0
20132014,Max Talbot,100,125,225,81,2,0.4444444444444444,160.0,143.0
20132014,Jay Beagle,296,277,573,62,2,0.5165794066317626,66.0,89.0
20132014,Mike Fisher,596,550,1146,75,2,0.5200698080279232,63.0,38.0
20132014,Tyler Ennis,242,383,625,80,2,0.3872,187.0,99.0
20132014,Alexander Steen,265,276,541,68,2,0.4898336414048059,102.0,94.0
20132014,Chris Kelly,283,296,579,57,2,0.48877374784110533,105.0,90.0
20132014,Alex Killorn,74,98,172,82,2,0.43023255813953487,170.0,157.0
20132014,Evgeni Malkin,303,318,621,60,2,0.48792270531400966,109.0,87.0
20132014,Daniel Winnik,85,111,196,76,2,0.4336734693877551,166.0,153.0
20132014,Trevor Lewis,127,135,262,73,2,0.4847328244274809,114.0,132.0
20132014,Tom Pyatt,101,92,193,27,2,0.5233160621761658,58.0,142.0
20132014,David Legwand,585,571,1156,83,2,0.5060553633217993,82.0,41.0
20132014,Mathieu Perreault,437,393,830,69,2,0.5265060240963856,54.0,68.0
20132014,Mike Richards,489,418,907,82,2,0.5391400220507166,31.0,60.0
20132014,Joe Thornton,617,482,1099,82,2,0.5614194722474978,16.0,33.0
20132014,Manny Malhotra,566,386,952,69,2,0.5945378151260504,6.0,44.0
20132014,Peter Holland,182,213,395,43,2,0.4607594936708861,142.0,119.0
20132014,Anze Kopitar,773,678,1451,82,2,0.5327360441075121,38.0,11.0
20132014,Matt Ellis,69,97,166,50,2,0.41566265060240964,180.0,159.0
20132014,Tyler Seguin,281,396,677,80,2,0.4150664697193501,181.0,91.0
20132014,Dave Bolland,152,185,337,23,2,0.45103857566765576,154.0,128.0
20132014,Jason Pominville,87,72,159,82,2,0.5471698113207547,22.0,151.0
20132014,David Backes,621,580,1201,74,2,0.5170691090757702,65.0,31.0
20132014,John Tavares,554,575,1129,59,2,0.49069973427812225,99.0,45.0
20132014,Patrik Elias,276,401,677,65,2,0.4076809453471196,184.0,92.0
20132014,Sean Monahan,476,560,1036,75,2,0.4594594594594595,147.0,62.0
20132014,Artem Anisimov,476,489,965,81,2,0.49326424870466323,95.0,62.0
20132014,Ryan Kesler,740,666,1406,77,2,0.5263157894736842,55.0,14.0
20132014,Andrew Shaw,296,388,684,80,2,0.4327485380116959,168.0,89.0
20132014,Joe Pavelski,675,531,1206,82,2,0.5597014925373134,17.0,26.0
20132014,Claude Giroux,931,829,1760,82,2,0.5289772727272727,45.0,4.0
20132014,Troy Brouwer,223,213,436,82,2,0.5114678899082569,73.0,102.0
20132014,Patrick Marleau,163,145,308,82,2,0.5292207792207793,44.0,124.0
20132014,Gregory Campbell,358,391,749,82,2,0.4779706275033378,124.0,77.0
20132014,Martin St. Louis,68,99,167,81,2,0.40718562874251496,185.0,160.0
20132014,Michael Cammalleri,88,103,191,63,2,0.4607329842931937,143.0,150.0
20132014,Jay McClement,676,584,1260,81,2,0.5365079365079365,34.0,25.0
20132014,Adam Hall,314,213,527,80,2,0.5958254269449715,5.0,85.0
20132014,Ryan Strome,165,209,374,37,2,0.4411764705882353,164.0,123.0
20132014,Riley Sheahan,251,261,512,42,2,0.490234375,101.0,98.0
20132014,Brooks Laich,203,257,460,51,2,0.44130434782608696,163.0,110.0
20132014,Jonathan Toews,884,660,1544,76,2,0.572538860103627,11.0,5.0
20132014,Scott Gomez,239,276,515,46,2,0.4640776699029126,138.0,100.0
20132014,Vincent Trocheck,166,182,348,20,2,0.47701149425287354,127.0,122.0
20132014,Mikael Granlund,415,374,789,63,2,0.5259822560202788,56.0,69.0
20132014,Ryan Johansen,692,619,1311,82,2,0.5278413424866514,48.0,20.0
20132014,Travis Zajac,761,633,1394,80,2,0.5459110473457676,25.0,12.0
20132014,Peter Regin,176,220,396,61,2,0.4444444444444444,160.0,120.0
20132014,David Krejci,618,590,1208,80,2,0.5115894039735099,72.0,32.0
20132014,Nathan MacKinnon,194,258,452,82,2,0.42920353982300885,171.0,114.0
20132014,Cody Eakin,585,638,1223,81,2,0.4783319705641864,123.0,41.0
20132014,Sean Couturier,646,707,1353,82,2,0.47745750184774577,125.0,29.0
20132014,Mark Letestu,374,356,730,82,2,0.5123287671232877,71.0,74.0
20132014,James Sheppard,105,128,233,67,2,0.45064377682403434,155.0,141.0
20132014,Josh Bailey,113,115,228,77,2,0.4956140350877193,92.0,138.0
20132014,Nick Spaling,88,79,167,71,2,0.5269461077844312,50.0,150.0
20132014,Shawn Matthias,183,250,433,77,2,0.4226327944572748,175.0,118.0
20132014,Steve Ott,494,423,917,82,2,0.5387131952017448,32.0,59.0
20132014,Dainius Zubrus,216,208,424,82,2,0.5094339622641509,75.0,104.0
20132014,TJ Galiardi,62,93,155,62,2,0.4,186.0,161.0
20132014,Mika Zibanejad,183,214,397,69,2,0.4609571788413098,141.0,118.0
20132014,Mikko Koivu,719,592,1311,65,2,0.5484363081617086,20.0,16.0
20132014,Nicklas Backstrom,714,701,1415,82,2,0.5045936395759717,83.0,17.0
20132014,Jeff Halpern,296,266,562,69,2,0.5266903914590747,52.0,89.0
20132014,Trevor Smith,115,143,258,28,2,0.44573643410852715,159.0,137.0
20132014,Kyle Turris,724,705,1429,82,2,0.5066480055983205,81.0,15.0
20132014,Patrick Sharp,83,69,152,82,2,0.5460526315789473,24.0,154.0
20132014,Nazem Kadri,510,617,1127,78,2,0.4525288376220053,151.0,56.0
20132014,Jussi Jokinen,160,139,299,81,2,0.5351170568561873,35.0,126.0
20132014,Martin Erat,97,116,213,70,2,0.45539906103286387,150.0,145.0
20132014,Olli Jokinen,612,718,1330,82,2,0.46015037593984964,145.0,35.0
20132014,Saku Koivu,538,529,1067,65,2,0.5042174320524836,84.0,48.0
20132014,Jamie Benn,411,367,778,81,2,0.5282776349614395,47.0,70.0
20132014,Brad Richardson,533,433,966,73,2,0.55175983436853,18.0,50.0
20132014,Andrew Desjardins,371,304,675,81,2,0.5496296296296296,19.0,76.0
20132014,Valtteri Filppula,693,633,1326,75,2,0.5226244343891403,60.0,19.0
20132014,Dominic Moore,354,294,648,73,2,0.5462962962962963,23.0,78.0
20132014,Colin Fraser,87,86,173,33,2,0.5028901734104047,86.0,151.0
20132014,Cody Hodgson,453,516,969,72,2,0.4674922600619195,137.0,64.0
20132014,Joel Ward,90,109,199,82,2,0.45226130653266333,152.0,148.0
20132014,Rich Peverley,348,231,579,62,2,0.6010362694300518,4.0,79.0
20132014,Carl Soderberg,139,189,328,73,2,0.42378048780487804,173.0,130.0
20132014,Cody McCormick,89,109,198,43,2,0.4494949494949495,156.0,149.0
20132014,Nick Bonino,583,611,1194,77,2,0.4882747068676717,108.0,42.0
20132014,Brandon Pirri,204,250,454,49,2,0.44933920704845814,157.0,109.0
20132014,Tyler Johnson,33,38,71,4,3,0.4647887323943662,55.0,47.0
20132014,Brandon Saad,14,29,43,19,3,0.32558139534883723,76.0,59.0
20132014,Michal Handzus,121,134,255,19,3,0.4745098039215686,49.0,16.0
20132014,Erik Haula,78,65,143,13,3,0.5454545454545454,18.0,24.0
20132014,Ryan O'Reilly,48,55,103,7,3,0.46601941747572817,54.0,39.0
20132014,Derek MacKenzie,19,14,33,6,3,0.5757575757575758,9.0,54.0
20132014,Vladimir Sobotka,59,44,103,6,3,0.5728155339805825,12.0,30.0
20132014,Darren Helm,27,25,52,5,3,0.5192307692307693,28.0,50.0
20132014,Vincent Lecavalier,22,30,52,7,3,0.4230769230769231,67.0,53.0
20132014,Derick Brassard,158,177,335,23,3,0.4716417910447761,51.0,11.0
20132014,Lars Eller,117,154,271,17,3,0.4317343173431734,65.0,17.0
20132014,Patrice Bergeron,174,129,303,12,3,0.5742574257425742,10.0,9.0
20132014,Nate Thompson,30,18,48,4,3,0.625,3.0,48.0
20132014,David Desharnais,169,164,333,17,3,0.5075075075075075,34.0,10.0
20132014,Pavel Datsyuk,55,49,104,5,3,0.5288461538461539,27.0,33.0
20132014,Brad Richards,140,156,296,25,3,0.47297297297297297,50.0,13.0
20132014,Maxim Lapierre,25,42,67,6,3,0.373134328358209,70.0,52.0
20132014,Sidney Crosby,157,138,295,13,3,0.5322033898305085,25.0,12.0
20132014,Steven Stamkos,17,16,33,4,3,0.5151515151515151,31.0,56.0
20132014,Marc-Andre Cliche,52,61,113,7,3,0.46017699115044247,57.0,36.0
20132014,Daniel Bri√®re,53,58,111,16,3,0.4774774774774775,47.0,35.0
20132014,Brandon Dubinsky,61,63,124,6,3,0.49193548387096775,38.0,28.0
20132014,Marcus Kruger,76,63,139,19,3,0.5467625899280576,17.0,25.0
20132014,Jarret Stoll,293,224,517,26,3,0.5667311411992263,13.0,2.0
20132014,Ben Smith,70,73,143,19,3,0.48951048951048953,40.0,27.0
20132014,Brandon Sutter,111,91,202,13,3,0.5495049504950495,16.0,18.0
20132014,Brayden Schenn,18,22,40,7,3,0.45,61.0,55.0
20132014,Joe Vitale,43,40,83,13,3,0.5180722891566265,29.0,41.0
20132014,Luke Glendening,16,33,49,5,3,0.32653061224489793,75.0,57.0
20132014,Marcel Goc,55,39,94,9,3,0.5851063829787234,7.0,33.0
20132014,Jeff Carter,139,150,289,26,3,0.4809688581314879,45.0,14.0
20132014,Ryan Getzlaf,89,137,226,12,3,0.3938053097345133,69.0,22.0
20132014,Logan Couture,52,57,109,7,3,0.47706422018348627,48.0,36.0
20132014,Brian Boyle,78,78,156,25,3,0.5,36.0,24.0
20132014,Derek Stepan,215,295,510,24,3,0.4215686274509804,68.0,4.0
20132014,Vernon Fiddler,61,40,101,6,3,0.6039603960396039,4.0,28.0
20132014,Tomas Plekanec,193,195,388,17,3,0.49742268041237114,37.0,5.0
20132014,Kyle Brodziak,61,80,141,12,3,0.4326241134751773,63.0,28.0
20132014,Paul Stastny,78,82,160,7,3,0.4875,41.0,24.0
20132014,Rickard Rakell,30,17,47,4,3,0.6382978723404256,2.0,48.0
20132014,Jonathan Toews,261,218,479,19,3,0.5448851774530271,20.0,3.0
20132014,Peter Regin,18,35,53,5,3,0.33962264150943394,73.0,55.0
20132014,Ryan Johansen,50,54,104,6,3,0.4807692307692308,46.0,37.0
20132014,Sean Couturier,57,60,117,7,3,0.48717948717948717,42.0,31.0
20132014,Mark Letestu,35,26,61,6,3,0.5737704918032787,11.0,46.0
20132014,Cody Eakin,56,64,120,6,3,0.4666666666666667,53.0,32.0
20132014,David Krejci,103,89,192,12,3,0.5364583333333334,23.0,19.0
20132014,Mikael Granlund,92,78,170,13,3,0.5411764705882353,21.0,21.0
20132014,Alexander Steen,14,28,42,6,3,0.3333333333333333,74.0,59.0
20132014,Evgeni Malkin,42,50,92,13,3,0.45652173913043476,60.0,42.0
20132014,Trevor Lewis,16,27,43,26,3,0.37209302325581395,71.0,57.0
20132014,Steve Ott,49,34,83,6,3,0.5903614457831325,6.0,38.0
20132014,Patrick Sharp,16,21,37,19,3,0.43243243243243246,64.0,57.0
20132014,Saku Koivu,100,77,177,13,3,0.5649717514124294,14.0,20.0
20132014,Jamie Benn,27,26,53,6,3,0.5094339622641509,33.0,50.0
20132014,Andrew Desjardins,30,26,56,7,3,0.5357142857142857,24.0,48.0
20132014,Valtteri Filppula,36,34,70,4,3,0.5142857142857142,32.0,45.0
20132014,Mathieu Perreault,59,78,137,11,3,0.4306569343065693,66.0,30.0
20132014,Mike Richards,180,154,334,26,3,0.5389221556886228,22.0,7.0
20132014,Joe Thornton,61,34,95,7,3,0.6421052631578947,1.0,28.0
20132014,Anze Kopitar,301,266,567,26,3,0.5308641975308642,26.0,1.0
20132014,David Backes,42,45,87,4,3,0.4827586206896552,44.0,42.0
20132014,Tyler Seguin,39,38,77,6,3,0.5064935064935064,35.0,43.0
20132014,Dominic Moore,175,146,321,25,3,0.5451713395638629,19.0,8.0
20132014,Carl Soderberg,72,77,149,12,3,0.48322147651006714,43.0,26.0
20132014,Nick Bonino,126,149,275,13,3,0.4581818181818182,58.0,15.0
20132014,Artem Anisimov,29,27,56,6,3,0.5178571428571429,30.0,49.0
20132014,Andrew Shaw,47,55,102,12,3,0.46078431372549017,56.0,40.0
20132014,Joe Pavelski,60,68,128,7,3,0.46875,52.0,29.0
20132014,Cedric Paquette,16,19,35,4,3,0.45714285714285713,59.0,57.0
20132014,James Sheppard,15,27,42,7,3,0.35714285714285715,72.0,58.0
20132014,Mikko Koivu,185,136,321,13,3,0.5763239875389408,8.0,6.0
20132014,Claude Giroux,83,64,147,7,3,0.564625850340136,15.0,23.0
20132014,Gregory Campbell,54,56,110,12,3,0.4909090909090909,39.0,34.0
20132014,Riley Sheahan,26,34,60,5,3,0.43333333333333335,62.0,51.0
20132014,Adam Hall,38,26,64,7,3,0.59375,5.0,44.0
20142015,James Sheppard,278,277,555,71,2,0.5009009009009009,85.0,103.0
20142015,Tyler Johnson,537,566,1103,77,2,0.48685403445149594,110.0,47.0
20142015,Brandon Pirri,86,89,175,49,2,0.49142857142857144,102.0,154.0
20142015,Pierre-Edouard Bellemare,360,401,761,81,2,0.4730617608409987,134.0,81.0
20142015,Marcel Goc,372,313,685,74,2,0.5430656934306569,23.0,77.0
20142015,Evgeny Kuznetsov,304,377,681,80,2,0.44640234948604995,164.0,96.0
20142015,Zack Smith,103,128,231,37,2,0.4458874458874459,165.0,146.0
20142015,Mikhail Grigorenko,153,178,331,25,2,0.4622356495468278,149.0,130.0
20142015,Riley Nash,488,470,958,68,2,0.5093945720250522,69.0,52.0
20142015,Erik Haula,260,313,573,72,2,0.4537521815008726,157.0,109.0
20142015,Johan Larsson,150,191,341,39,2,0.4398826979472141,172.0,132.0
20142015,Kevin Hayes,247,434,681,79,2,0.36270190895741555,192.0,111.0
20142015,Manny Malhotra,537,369,906,58,2,0.5927152317880795,3.0,47.0
20142015,Ryan O'Reilly,713,621,1334,82,2,0.5344827586206896,31.0,17.0
20142015,Henrik Zetterberg,541,523,1064,77,2,0.5084586466165414,71.0,46.0
20142015,Nick Foligno,125,138,263,79,2,0.4752851711026616,131.0,141.0
20142015,Nicholas Shore,127,109,236,34,2,0.538135593220339,27.0,139.0
20142015,Scott Gomez,367,421,788,58,2,0.46573604060913704,146.0,79.0
20142015,Pavel Datsyuk,601,521,1122,63,2,0.535650623885918,30.0,36.0
20142015,Casey Cizikas,446,409,855,70,2,0.5216374269005848,52.0,66.0
20142015,Darren Helm,223,198,421,75,2,0.5296912114014252,37.0,115.0
20142015,Ryan Nugent-Hopkins,620,736,1356,76,2,0.45722713864306785,154.0,32.0
20142015,Vincent Lecavalier,95,96,191,57,2,0.4973821989528796,91.0,151.0
20142015,Maxim Lapierre,305,277,582,80,2,0.5240549828178694,43.0,95.0
20142015,Derick Brassard,671,705,1376,80,2,0.4876453488372093,108.0,22.0
20142015,Lars Eller,405,379,784,77,2,0.5165816326530612,59.0,72.0
20142015,Matt Hendricks,98,100,198,71,2,0.494949494949495,94.0,149.0
20142015,Patrik Berglund,160,169,329,77,2,0.48632218844984804,114.0,126.0
20142015,David Desharnais,629,560,1189,82,2,0.5290159798149706,39.0,29.0
20142015,Eric Fehr,449,414,863,75,2,0.5202780996523755,53.0,64.0
20142015,Patrice Bergeron,1175,776,1951,81,2,0.602255253716043,1.0,1.0
20142015,Andre Burakovsky,74,93,167,53,2,0.4431137724550898,168.0,159.0
20142015,Elias Lindholm,115,105,220,81,2,0.5227272727272727,47.0,143.0
20142015,Boyd Gordon,681,537,1218,68,2,0.5591133004926109,17.0,21.0
20142015,Charlie Coyle,334,384,718,82,2,0.46518105849582175,147.0,89.0
20142015,Markus Granlund,193,331,524,48,2,0.3683206106870229,190.0,120.0
20142015,Shawn Horcoff,237,235,472,76,2,0.5021186440677966,81.0,112.0
20142015,Nate Thompson,557,499,1056,80,2,0.5274621212121212,40.0,42.0
20142015,Jarret Stoll,592,569,1161,73,2,0.5099052540913006,67.0,37.0
20142015,Linden Vey,215,287,502,75,2,0.42828685258964144,178.0,118.0
20142015,Paul Stastny,671,487,1158,74,2,0.5794473229706391,5.0,22.0
20142015,Ben Smith,310,284,594,80,2,0.5218855218855218,50.0,94.0
20142015,Jim Slater,448,303,751,82,2,0.596537949400799,2.0,65.0
20142015,Jeff Carter,627,566,1193,82,2,0.5255658005029338,42.0,30.0
20142015,Bryan Little,762,789,1551,70,2,0.4912959381044487,103.0,13.0
20142015,Matt Stajan,303,299,602,59,2,0.5033222591362126,80.0,97.0
20142015,Martin Hanzal,346,266,612,37,2,0.565359477124183,9.0,84.0
20142015,Brian Flynn,172,187,359,63,2,0.479108635097493,127.0,124.0
20142015,Torrey Mitchell,399,415,814,65,2,0.49017199017199015,104.0,74.0
20142015,Brandon Dubinsky,436,423,859,47,2,0.5075669383003493,74.0,68.0
20142015,Marcus Kruger,357,313,670,81,2,0.5328358208955224,33.0,82.0
20142015,Brad Richards,399,426,825,76,2,0.48363636363636364,117.0,74.0
20142015,Colin Wilson,71,107,178,77,2,0.398876404494382,187.0,160.0
20142015,Matt Cullen,155,132,287,62,2,0.5400696864111498,25.0,129.0
20142015,Anton Lander,226,225,451,38,2,0.5011086474501109,84.0,114.0
20142015,Derek Stepan,543,689,1232,68,2,0.4407467532467532,170.0,45.0
20142015,William Karlsson,93,104,197,21,2,0.4720812182741117,137.0,152.0
20142015,Vernon Fiddler,569,528,1097,80,2,0.5186873290793071,57.0,41.0
20142015,John Mitchell,374,361,735,68,2,0.508843537414966,70.0,76.0
20142015,Jacob Josefson,289,297,586,62,2,0.4931740614334471,98.0,101.0
20142015,Tomas Plekanec,777,780,1557,82,2,0.49903660886319845,89.0,12.0
20142015,Calle Jarnkrok,296,345,641,74,2,0.46177847113884557,150.0,99.0
20142015,Victor Rask,468,450,918,80,2,0.5098039215686274,68.0,60.0
20142015,Cody McCormick,147,147,294,33,2,0.5,87.0,134.0
20142015,Nick Spaling,84,90,174,82,2,0.4827586206896552,121.0,155.0
20142015,Jordan Staal,499,386,885,46,2,0.5638418079096045,12.0,50.0
20142015,Leo Komarov,95,97,192,62,2,0.4947916666666667,95.0,151.0
20142015,Derek MacKenzie,543,479,1022,82,2,0.5313111545988258,36.0,45.0
20142015,Logan Couture,477,513,990,82,2,0.4818181818181818,123.0,55.0
20142015,Tyler Bozak,944,831,1775,82,2,0.5318309859154929,35.0,5.0
20142015,Paul Gaustad,619,478,1097,73,2,0.5642661804922516,11.0,33.0
20142015,Boone Jenner,151,155,306,31,2,0.4934640522875817,97.0,131.0
20142015,Rickard Rakell,310,355,665,71,2,0.46616541353383456,144.0,94.0
20142015,Stephen Gionta,159,235,394,61,2,0.4035532994923858,185.0,127.0
20142015,Ryan Kesler,937,727,1664,81,2,0.5631009615384616,14.0,6.0
20142015,Joakim Andersson,192,183,375,68,2,0.512,65.0,121.0
20142015,Sidney Crosby,797,800,1597,77,2,0.49906073888541014,88.0,11.0
20142015,Matt Duchene,635,582,1217,82,2,0.5217748562037798,51.0,27.0
20142015,Steven Stamkos,469,474,943,82,2,0.4973488865323436,92.0,59.0
20142015,Sam Gagner,361,410,771,81,2,0.4682230869001297,141.0,80.0
20142015,Nick Bjugstad,486,508,994,72,2,0.48893360160965793,105.0,53.0
20142015,Brandon Sutter,688,671,1359,80,2,0.5062545989698307,76.0,19.0
20142015,Zemgus Girgensons,440,560,1000,61,2,0.44,171.0,67.0
20142015,Mikael Backlund,423,452,875,52,2,0.48342857142857143,119.0,69.0
20142015,Brayden Schenn,86,98,184,82,2,0.4673913043478261,142.0,154.0
20142015,Ryan Getzlaf,632,617,1249,77,2,0.5060048038430744,77.0,28.0
20142015,Henrik Sedin,704,861,1565,82,2,0.44984025559105434,161.0,18.0
20142015,Mark Scheifele,492,656,1148,82,2,0.42857142857142855,177.0,51.0
20142015,Leon Draisaitl,128,187,315,37,2,0.40634920634920635,183.0,138.0
20142015,Kyle Brodziak,338,349,687,73,2,0.49199417758369723,100.0,87.0
20142015,Bo Horvat,436,412,848,68,2,0.5141509433962265,62.0,68.0
20142015,Mark Arcobello,471,468,939,77,2,0.5015974440894568,82.0,58.0
20142015,Marc-Andre Cliche,377,358,735,74,2,0.5129251700680272,63.0,75.0
20142015,Kyle Okposo,80,81,161,60,2,0.4968944099378882,93.0,157.0
20142015,Frans Nielsen,506,544,1050,78,2,0.4819047619047619,122.0,49.0
20142015,Brock Nelson,354,445,799,82,2,0.4430538172715895,169.0,83.0
20142015,Michael Chaput,143,151,294,33,2,0.48639455782312924,113.0,135.0
20142015,Michael Cammalleri,119,163,282,68,2,0.4219858156028369,181.0,142.0
20142015,Aleksander Barkov,462,540,1002,71,2,0.46107784431137727,152.0,61.0
20142015,Luke Glendening,499,463,962,82,2,0.5187110187110187,56.0,50.0
20142015,Adam Henrique,270,249,519,75,2,0.5202312138728323,54.0,106.0
20142015,Antoine Vermette,872,705,1577,82,2,0.5529486366518707,19.0,8.0
20142015,J.T. Miller,93,112,205,58,2,0.45365853658536587,158.0,152.0
20142015,Jason Spezza,682,580,1262,82,2,0.5404120443740095,24.0,20.0
20142015,Eric Staal,343,326,669,77,2,0.5127055306427504,64.0,85.0
20142015,Joe Colborne,176,160,336,64,2,0.5238095238095238,45.0,122.0
20142015,Alex Galchenyuk,82,92,174,80,2,0.47126436781609193,138.0,156.0
20142015,Jean-Gabriel Pageau,335,346,681,50,2,0.4919236417033774,101.0,88.0
20142015,Phil Varone,147,179,326,28,2,0.450920245398773,160.0,134.0
20142015,Jay Beagle,217,167,384,62,2,0.5651041666666666,10.0,117.0
20142015,Mike Fisher,601,548,1149,59,2,0.5230635335073978,46.0,36.0
20142015,Brian Gionta,69,100,169,69,2,0.40828402366863903,182.0,162.0
20142015,Tyler Ennis,67,116,183,78,2,0.366120218579235,191.0,163.0
20142015,Alexander Steen,218,215,433,74,2,0.5034642032332564,79.0,116.0
20142015,Chris Kelly,262,277,539,80,2,0.48608534322820035,115.0,108.0
20142015,Steve Ott,160,124,284,78,2,0.5633802816901409,13.0,126.0
20142015,Evgeni Malkin,322,433,755,69,2,0.42649006622516555,180.0,90.0
20142015,Dave Bolland,414,517,931,53,2,0.4446831364124597,167.0,70.0
20142015,Kyle Chipchura,473,443,916,70,2,0.5163755458515283,60.0,57.0
20142015,Trevor Lewis,76,101,177,73,2,0.4293785310734463,176.0,158.0
20142015,Mike Richards,289,304,593,53,2,0.4873524451939292,109.0,101.0
20142015,Joe Thornton,554,401,955,78,2,0.5801047120418849,4.0,43.0
20142015,Anze Kopitar,752,678,1430,79,2,0.5258741258741259,41.0,15.0
20142015,Matt Ellis,100,105,205,39,2,0.4878048780487805,106.0,148.0
20142015,Tyler Seguin,275,236,511,71,2,0.538160469667319,26.0,105.0
20142015,Drew Stafford,86,88,174,76,2,0.4942528735632184,96.0,154.0
20142015,David Backes,617,513,1130,80,2,0.5460176991150443,21.0,34.0
20142015,Nick Bonino,590,655,1245,75,2,0.4738955823293173,132.0,38.0
20142015,John Tavares,753,689,1442,82,2,0.5221914008321775,49.0,14.0
20142015,Shawn Matthias,84,103,187,78,2,0.44919786096256686,162.0,155.0
20142015,Patrik Elias,263,410,673,69,2,0.39078751857355126,189.0,107.0
20142015,Daniel Winnik,107,121,228,79,2,0.4692982456140351,140.0,145.0
20142015,Sean Monahan,902,928,1830,81,2,0.492896174863388,99.0,7.0
20142015,Peter Holland,312,373,685,62,2,0.4554744525547445,155.0,93.0
20142015,Artem Anisimov,102,127,229,52,2,0.44541484716157204,166.0,147.0
20142015,Adam Lowry,402,449,851,80,2,0.47238542890716806,136.0,73.0
20142015,Andrew Shaw,357,355,712,79,2,0.5014044943820225,83.0,82.0
20142015,Chris Tierney,150,192,342,43,2,0.43859649122807015,174.0,132.0
20142015,Joe Pavelski,642,505,1147,82,2,0.5597210113339146,16.0,25.0
20142015,Mike Santorelli,86,100,186,79,2,0.46236559139784944,148.0,154.0
20142015,Claude Giroux,1063,815,1878,81,2,0.566027689030884,7.0,2.0
20142015,Max Talbot,76,82,158,81,2,0.4810126582278481,125.0,158.0
20142015,Joe Vitale,354,379,733,70,2,0.4829467939972715,120.0,83.0
20142015,Troy Brouwer,251,190,441,82,2,0.5691609977324263,6.0,110.0
20142015,Patrick Marleau,171,185,356,82,2,0.4803370786516854,126.0,125.0
20142015,Gregory Campbell,339,293,632,70,2,0.5363924050632911,28.0,86.0
20142015,Mike Ribeiro,582,766,1348,82,2,0.4317507418397626,175.0,40.0
20142015,Ryan Strome,149,170,319,81,2,0.4670846394984326,143.0,133.0
20142015,Riley Sheahan,484,486,970,79,2,0.49896907216494846,90.0,54.0
20142015,Jacob de la Rose,64,96,160,33,2,0.4,186.0,164.0
20142015,Brooks Laich,87,111,198,66,2,0.4393939393939394,173.0,153.0
20142015,Jonathan Toews,947,728,1675,81,2,0.5653731343283582,8.0,4.0
20142015,Vincent Trocheck,234,247,481,50,2,0.4864864864864865,112.0,113.0
20142015,Jay McClement,549,441,990,82,2,0.5545454545454546,18.0,44.0
20142015,Jori Lehtera,543,518,1061,75,2,0.5117813383600377,66.0,45.0
20142015,Mikael Granlund,476,508,984,68,2,0.483739837398374,116.0,56.0
20142015,Ryan Johansen,851,787,1638,82,2,0.5195360195360196,55.0,10.0
20142015,Travis Zajac,641,559,1200,74,2,0.5341666666666667,32.0,26.0
20142015,Michael Latta,160,175,335,53,2,0.47761194029850745,128.0,126.0
20142015,David Krejci,316,278,594,47,2,0.531986531986532,34.0,92.0
20142015,Nathan MacKinnon,201,227,428,64,2,0.4696261682242991,139.0,119.0
20142015,Brad Boyes,97,76,173,78,2,0.5606936416184971,15.0,150.0
20142015,Cody Eakin,656,636,1292,78,2,0.5077399380804953,73.0,23.0
20142015,Sean Couturier,643,687,1330,82,2,0.48345864661654137,118.0,24.0
20142015,Mark Letestu,319,284,603,54,2,0.5290215588723052,38.0,91.0
20142015,Jussi Jokinen,126,124,250,81,2,0.504,78.0,140.0
20142015,Cedric Paquette,112,123,235,64,2,0.4765957446808511,130.0,144.0
20142015,Derek Roy,407,502,909,72,2,0.44774477447744776,163.0,71.0
20142015,David Legwand,451,517,968,80,2,0.4659090909090909,145.0,63.0
20142015,Tommy Wingels,70,84,154,75,2,0.45454545454545453,156.0,161.0
20142015,Mika Zibanejad,615,646,1261,80,2,0.48770816812053924,107.0,35.0
20142015,Vladislav Namestnikov,70,85,155,43,2,0.45161290322580644,159.0,161.0
20142015,Mikko Koivu,989,802,1791,80,2,0.5522054718034618,20.0,3.0
20142015,Nicklas Backstrom,862,747,1609,82,2,0.5357364822871349,29.0,9.0
20142015,Alex Wennberg,288,386,674,68,2,0.42729970326409494,179.0,102.0
20142015,Mathieu Perreault,226,212,438,62,2,0.5159817351598174,61.0,114.0
20142015,Trevor Smith,293,268,561,54,2,0.5222816399286988,48.0,100.0
20142015,Kyle Turris,737,735,1472,82,2,0.5006793478260869,86.0,16.0
20142015,Andrew Desjardins,158,154,312,69,2,0.5064102564102564,75.0,128.0
20142015,Scott Laughton,134,149,283,31,2,0.4734982332155477,133.0,136.0
20142015,Nazem Kadri,528,616,1144,73,2,0.46153846153846156,151.0,48.0
20142015,Brian Boyle,460,445,905,82,2,0.5082872928176796,72.0,62.0
20142015,Jamie Benn,298,278,576,82,2,0.5173611111111112,58.0,98.0
20142015,Brad Richardson,276,302,578,45,2,0.47750865051903113,129.0,104.0
20142015,Ryan Spooner,100,120,220,29,2,0.45454545454545453,156.0,148.0
20142015,Valtteri Filppula,621,564,1185,82,2,0.5240506329113924,44.0,31.0
20142015,Olli Jokinen,134,196,330,62,2,0.40606060606060607,184.0,136.0
20142015,Curtis Lazar,129,144,273,67,2,0.4725274725274725,135.0,137.0
20142015,Dominic Moore,585,489,1074,82,2,0.5446927374301676,22.0,39.0
20142015,Cody Hodgson,173,204,377,78,2,0.4588859416445623,153.0,123.0
20142015,Tim Schaller,74,112,186,18,2,0.3978494623655914,188.0,159.0
20142015,Carl Soderberg,369,397,766,82,2,0.48172323759791125,124.0,78.0
20142015,Josh Jooris,276,291,567,60,2,0.48677248677248675,111.0,104.0
20142015,Tyler Johnson,176,178,354,26,3,0.4971751412429379,37.0,6.0
20142015,Evgeny Kuznetsov,80,86,166,14,3,0.4819277108433735,43.0,24.0
20142015,Marcel Goc,20,15,35,4,3,0.5714285714285714,10.0,57.0
20142015,Kevin Hayes,45,71,116,19,3,0.3879310344827586,66.0,40.0
20142015,Henrik Zetterberg,49,44,93,7,3,0.5268817204301075,25.0,37.0
20142015,Casey Cizikas,43,48,91,7,3,0.4725274725274725,46.0,42.0
20142015,Derick Brassard,157,180,337,19,3,0.4658753709198813,47.0,8.0
20142015,Lars Eller,97,72,169,12,3,0.5739644970414202,9.0,19.0
20142015,David Desharnais,81,81,162,11,3,0.5,36.0,23.0
20142015,Pavel Datsyuk,56,71,127,7,3,0.4409448818897638,57.0,35.0
20142015,Charlie Coyle,43,61,104,10,3,0.41346153846153844,63.0,42.0
20142015,Nate Thompson,99,70,169,12,3,0.5857988165680473,6.0,18.0
20142015,Calle Jarnkrok,41,40,81,6,3,0.5061728395061729,33.0,44.0
20142015,Ryan Kesler,221,163,384,16,3,0.5755208333333334,8.0,2.0
20142015,Sidney Crosby,61,50,111,5,3,0.5495495495495496,16.0,32.0
20142015,Steven Stamkos,116,111,227,26,3,0.5110132158590308,30.0,16.0
20142015,Frans Nielsen,36,42,78,7,3,0.46153846153846156,48.0,47.0
20142015,Marcus Kruger,115,115,230,23,3,0.5,36.0,17.0
20142015,Brad Richards,151,153,304,23,3,0.4967105263157895,38.0,10.0
20142015,Joakim Andersson,17,18,35,7,3,0.4857142857142857,42.0,59.0
20142015,Antoine Vermette,166,116,282,20,3,0.5886524822695035,5.0,7.0
20142015,Torrey Mitchell,70,71,141,12,3,0.49645390070921985,39.0,28.0
20142015,Brandon Sutter,34,33,67,5,3,0.5074626865671642,32.0,49.0
20142015,Mikael Backlund,71,86,157,11,3,0.45222929936305734,53.0,27.0
20142015,Maxim Lapierre,47,29,76,5,3,0.618421052631579,2.0,39.0
20142015,Paul Stastny,60,46,106,6,3,0.5660377358490566,11.0,33.0
20142015,Brock Nelson,20,27,47,6,3,0.425531914893617,60.0,57.0
20142015,Matt Cullen,50,42,92,6,3,0.5434782608695652,20.0,36.0
20142015,Luke Glendening,41,49,90,7,3,0.45555555555555555,52.0,44.0
20142015,Jim Slater,16,20,36,4,3,0.4444444444444444,56.0,60.0
20142015,Ryan Getzlaf,177,169,346,16,3,0.5115606936416185,29.0,5.0
20142015,Mark Scheifele,35,46,81,4,3,0.43209876543209874,59.0,48.0
20142015,Ondrej Palat,24,43,67,26,3,0.3582089552238806,71.0,54.0
20142015,Kyle Brodziak,44,73,117,10,3,0.37606837606837606,69.0,41.0
20142015,Paul Gaustad,65,51,116,6,3,0.5603448275862069,13.0,30.0
20142015,Mikhail Grabovski,22,19,41,3,3,0.5365853658536586,22.0,55.0
20142015,Derek Stepan,130,184,314,19,3,0.4140127388535032,62.0,14.0
20142015,Tomas Plekanec,143,134,277,12,3,0.516245487364621,27.0,11.0
20142015,Henrik Sedin,66,65,131,6,3,0.5038167938931297,35.0,29.0
20142015,Jean-Gabriel Pageau,47,46,93,6,3,0.5053763440860215,34.0,39.0
20142015,Jay Beagle,120,68,188,14,3,0.6382978723404256,1.0,15.0
20142015,Mike Fisher,16,19,35,3,3,0.45714285714285713,51.0,60.0
20142015,Alexander Steen,14,18,32,6,3,0.4375,58.0,61.0
20142015,Steve Ott,21,17,38,6,3,0.5526315789473685,15.0,56.0
20142015,Evgeni Malkin,27,27,54,5,3,0.5,36.0,52.0
20142015,Kyle Turris,73,61,134,6,3,0.5447761194029851,19.0,26.0
20142015,Brian Boyle,140,147,287,25,3,0.4878048780487805,41.0,12.0
20142015,Brad Richardson,22,27,49,5,3,0.4489795918367347,54.0,55.0
20142015,Valtteri Filppula,212,197,409,26,3,0.5183374083129584,26.0,3.0
20142015,Matt Stajan,95,78,173,11,3,0.5491329479768786,17.0,20.0
20142015,Bo Horvat,39,25,64,6,3,0.609375,3.0,45.0
20142015,J.T. Miller,30,25,55,19,3,0.5454545454545454,18.0,50.0
20142015,Rickard Rakell,74,91,165,16,3,0.4484848484848485,55.0,25.0
20142015,Bryan Little,48,41,89,4,3,0.5393258426966292,21.0,38.0
20142015,Cedric Paquette,58,96,154,24,3,0.37662337662337664,68.0,34.0
20142015,Mika Zibanejad,34,60,94,6,3,0.3617021276595745,70.0,49.0
20142015,Mikko Koivu,131,115,246,10,3,0.532520325203252,23.0,13.0
20142015,James Sheppard,18,27,45,13,3,0.4,65.0,58.0
20142015,Nicklas Backstrom,182,129,311,14,3,0.5852090032154341,7.0,4.0
20142015,David Backes,62,59,121,6,3,0.512396694214876,28.0,31.0
20142015,Nick Bonino,42,46,88,6,3,0.4772727272727273,44.0,43.0
20142015,John Tavares,47,69,116,7,3,0.4051724137931034,64.0,39.0
20142015,Dominic Moore,152,120,272,19,3,0.5588235294117647,14.0,9.0
20142015,Josh Jooris,28,25,53,9,3,0.5283018867924528,24.0,51.0
20142015,Troy Brouwer,25,24,49,14,3,0.5102040816326531,31.0,53.0
20142015,Mike Ribeiro,44,52,96,6,3,0.4583333333333333,50.0,41.0
20142015,Riley Sheahan,22,35,57,7,3,0.38596491228070173,67.0,55.0
20142015,Brooks Laich,38,42,80,14,3,0.475,45.0,46.0
20142015,Jonathan Toews,296,232,528,23,3,0.5606060606060606,12.0,1.0
20142015,Jori Lehtera,27,18,45,5,3,0.6,4.0,52.0
20142015,Mikael Granlund,70,72,142,10,3,0.49295774647887325,40.0,28.0
20142015,Sean Monahan,94,133,227,11,3,0.41409691629955947,61.0,21.0
20142015,Adam Lowry,28,33,61,4,3,0.45901639344262296,49.0,51.0
20142015,Andrew Shaw,85,85,170,23,3,0.5,36.0,22.0
20152016,Tyler Johnson,479,507,986,69,2,0.48580121703853957,104.0,50.0
20152016,Pierre-Edouard Bellemare,272,307,579,74,2,0.4697754749568221,124.0,91.0
20152016,T.J. Oshie,138,124,262,80,2,0.5267175572519084,40.0,132.0
20152016,Evgeny Kuznetsov,543,594,1137,82,2,0.47757255936675463,111.0,38.0
20152016,Zack Smith,380,349,729,81,2,0.5212620027434842,47.0,69.0
20152016,Ryan White,184,167,351,73,2,0.5242165242165242,43.0,115.0
20152016,Riley Nash,193,197,390,64,2,0.4948717948717949,86.0,113.0
20152016,Erik Haula,416,365,781,76,2,0.5326504481434059,36.0,61.0
20152016,Craig Smith,76,154,230,82,2,0.33043478260869563,172.0,151.0
20152016,Johan Larsson,388,371,759,74,2,0.5111989459815547,63.0,67.0
20152016,Kevin Hayes,137,244,381,79,2,0.35958005249343833,170.0,133.0
20152016,Kyle Brodziak,275,281,556,76,2,0.49460431654676257,88.0,90.0
20152016,Ryan O'Reilly,1024,788,1812,71,2,0.565121412803532,11.0,3.0
20152016,Henrik Zetterberg,539,536,1075,82,2,0.5013953488372093,77.0,39.0
20152016,Nick Foligno,83,93,176,72,2,0.4715909090909091,120.0,150.0
20152016,Nicholas Shore,384,357,741,68,2,0.5182186234817814,51.0,68.0
20152016,Adam Cracknell,156,239,395,52,2,0.3949367088607595,167.0,123.0
20152016,Pavel Datsyuk,599,517,1116,66,2,0.5367383512544803,33.0,28.0
20152016,Casey Cizikas,469,490,959,80,2,0.48905109489051096,97.0,53.0
20152016,Ryan Nugent-Hopkins,369,454,823,55,2,0.44835965978128794,144.0,74.0
20152016,Mark Arcobello,132,110,242,20,2,0.5454545454545454,28.0,136.0
20152016,Derick Brassard,676,670,1346,80,2,0.5022288261515602,75.0,18.0
20152016,Lars Eller,207,202,409,79,2,0.5061124694376528,71.0,108.0
20152016,Matt Hendricks,251,202,453,68,2,0.5540838852097131,21.0,95.0
20152016,Patrik Berglund,139,138,277,42,2,0.5018050541516246,76.0,131.0
20152016,Eric Fehr,107,135,242,55,2,0.44214876033057854,149.0,142.0
20152016,David Desharnais,391,412,803,65,2,0.48692403486924035,101.0,66.0
20152016,Patrice Bergeron,1130,848,1978,80,2,0.5712841253791708,9.0,1.0
20152016,Elias Lindholm,213,221,434,82,2,0.49078341013824883,96.0,107.0
20152016,Charlie Coyle,228,274,502,82,2,0.4541832669322709,142.0,101.0
20152016,Nate Thompson,235,216,451,49,2,0.5210643015521065,48.0,98.0
20152016,Martin Hanzal,586,461,1047,64,2,0.559694364851958,16.0,32.0
20152016,Calle Jarnkrok,366,433,799,81,2,0.45807259073842305,136.0,76.0
20152016,Victor Rask,479,456,935,80,2,0.5122994652406417,62.0,50.0
20152016,Ryan Johansen,652,594,1246,80,2,0.5232744783306581,45.0,22.0
20152016,Stephen Gionta,291,400,691,82,2,0.4211287988422576,159.0,87.0
20152016,Ryan Kesler,980,695,1675,79,2,0.5850746268656717,2.0,6.0
20152016,Sidney Crosby,986,921,1907,80,2,0.5170424750917672,53.0,5.0
20152016,Matt Duchene,428,311,739,76,2,0.5791610284167794,4.0,59.0
20152016,Steven Stamkos,463,464,927,77,2,0.4994606256742179,82.0,54.0
20152016,Nick Bjugstad,449,419,868,67,2,0.5172811059907834,52.0,56.0
20152016,Luke Glendening,614,511,1125,81,2,0.5457777777777778,27.0,27.0
20152016,Logan Couture,271,305,576,52,2,0.4704861111111111,123.0,92.0
20152016,Jack Eichel,402,578,980,81,2,0.41020408163265304,163.0,63.0
20152016,Tyler Bozak,597,462,1059,57,2,0.5637393767705382,12.0,30.0
20152016,Paul Gaustad,427,345,772,63,2,0.5531088082901554,22.0,60.0
20152016,Mikhail Grabovski,221,242,463,58,2,0.4773218142548596,112.0,105.0
20152016,Andrew Copp,224,262,486,77,2,0.4609053497942387,132.0,104.0
20152016,William Nylander,143,148,291,22,2,0.49140893470790376,94.0,129.0
20152016,Boone Jenner,156,138,294,82,2,0.5306122448979592,37.0,123.0
20152016,Rickard Rakell,197,254,451,72,2,0.43680709534368073,153.0,111.0
20152016,Ben Smith,100,85,185,22,2,0.5405405405405406,31.0,145.0
20152016,Eric Staal,446,396,842,83,2,0.5296912114014252,39.0,57.0
20152016,Frans Nielsen,586,583,1169,81,2,0.5012831479897348,79.0,32.0
20152016,Linden Vey,193,256,449,41,2,0.4298440979955457,156.0,113.0
20152016,Max Talbot,164,181,345,38,2,0.4753623188405797,115.0,120.0
20152016,Andy Andreoff,134,134,268,60,2,0.5,81.0,135.0
20152016,Brandon Sutter,146,132,278,20,2,0.5251798561151079,42.0,127.0
20152016,Paul Stastny,684,536,1220,64,2,0.5606557377049181,14.0,17.0
20152016,Marcus Johansson,128,150,278,74,2,0.460431654676259,133.0,137.0
20152016,Mark Letestu,596,566,1162,82,2,0.5129087779690189,61.0,31.0
20152016,Sergey Kalinin,134,188,322,78,2,0.4161490683229814,161.0,135.0
20152016,Bryan Little,674,640,1314,57,2,0.512937595129376,60.0,19.0
20152016,Matt Stajan,373,415,788,80,2,0.4733502538071066,118.0,72.0
20152016,Markus Granlund,202,270,472,47,2,0.4279661016949153,157.0,109.0
20152016,Alexander Steen,159,198,357,67,2,0.44537815126050423,147.0,122.0
20152016,Brandon Dubinsky,780,704,1484,75,2,0.5256064690026954,41.0,12.0
20152016,Marcus Kruger,233,241,474,41,2,0.49156118143459915,93.0,99.0
20152016,Oscar Lindberg,134,143,277,68,2,0.48375451263537905,108.0,135.0
20152016,Zemgus Girgensons,153,182,335,71,2,0.45671641791044776,140.0,124.0
20152016,Colton Sissons,141,111,252,34,2,0.5595238095238095,17.0,130.0
20152016,Mikael Backlund,539,604,1143,82,2,0.4715660542432196,121.0,39.0
20152016,Adam Henrique,617,764,1381,80,2,0.44677769732078204,146.0,26.0
20152016,Shawn Horcoff,320,306,626,59,2,0.5111821086261981,64.0,81.0
20152016,Gregory Campbell,229,253,482,82,2,0.475103734439834,116.0,100.0
20152016,Bo Horvat,760,733,1493,82,2,0.5090421969189551,66.0,13.0
20152016,William Karlsson,416,495,911,81,2,0.4566410537870472,141.0,61.0
20152016,Nick Cousins,109,128,237,36,2,0.459915611814346,134.0,141.0
20152016,Evgeni Malkin,317,438,755,57,2,0.4198675496688742,160.0,82.0
20152016,Dave Bolland,156,185,341,25,2,0.4574780058651026,138.0,123.0
20152016,Connor McDavid,249,355,604,45,2,0.41225165562913907,162.0,96.0
20152016,Jordan Staal,806,589,1395,82,2,0.5777777777777777,7.0,10.0
20152016,Derek MacKenzie,439,362,801,64,2,0.5480649188514357,26.0,58.0
20152016,Torrey Mitchell,370,347,717,71,2,0.5160390516039052,54.0,73.0
20152016,Brooks Laich,98,145,243,81,2,0.40329218106995884,165.0,146.0
20152016,Jeff Carter,598,630,1228,77,2,0.48697068403908794,100.0,29.0
20152016,Derek Stepan,515,588,1103,72,2,0.4669084315503173,126.0,46.0
20152016,Vernon Fiddler,455,442,897,82,2,0.5072463768115942,70.0,55.0
20152016,John Mitchell,415,434,849,71,2,0.48881036513545345,98.0,62.0
20152016,Jacob Josefson,323,344,667,58,2,0.48425787106446777,106.0,80.0
20152016,Blake Comeau,276,290,566,81,2,0.4876325088339223,99.0,89.0
20152016,Tomas Plekanec,804,811,1615,82,2,0.4978328173374613,84.0,11.0
20152016,Jean-Gabriel Pageau,614,563,1177,82,2,0.5216652506372133,46.0,27.0
20152016,Sam Bennett,160,187,347,77,2,0.4610951008645533,131.0,121.0
20152016,Jay Beagle,370,267,637,57,2,0.5808477237048666,3.0,73.0
20152016,Mike Fisher,668,582,1250,70,2,0.5344,35.0,20.0
20152016,Brad Richardson,523,438,961,82,2,0.5442247658688866,29.0,44.0
20152016,Brock Nelson,186,202,388,81,2,0.4793814432989691,110.0,114.0
20152016,Aleksander Barkov,569,587,1156,66,2,0.4922145328719723,91.0,34.0
20152016,David Legwand,196,231,427,79,2,0.45901639344262296,135.0,112.0
20152016,Aleksander Barkov,569,587,1156,66,2,0.4922145328719723,91.0,34.0
20152016,David Legwand,196,231,427,79,2,0.45901639344262296,135.0,112.0
20152016,Anton Lander,378,315,693,61,2,0.5454545454545454,28.0,70.0
20152016,Adam Henrique,617,764,1381,80,2,0.44677769732078204,146.0,26.0
20152016,Shawn Horcoff,320,306,626,59,2,0.5111821086261981,64.0,81.0
20152016,Gregory Campbell,229,253,482,82,2,0.475103734439834,116.0,100.0
20152016,Bo Horvat,760,733,1493,82,2,0.5090421969189551,66.0,13.0
20152016,William Karlsson,416,495,911,81,2,0.4566410537870472,141.0,61.0
20152016,Nick Cousins,109,128,237,36,2,0.459915611814346,134.0,141.0
20152016,Evgeni Malkin,317,438,755,57,2,0.4198675496688742,160.0,82.0
20152016,Dave Bolland,156,185,341,25,2,0.4574780058651026,138.0,123.0
20152016,Kyle Chipchura,88,80,168,70,2,0.5238095238095238,44.0,148.0
20152016,Brian Flynn,200,146,346,56,2,0.5780346820809249,6.0,110.0
20152016,Trevor Lewis,103,154,257,75,2,0.40077821011673154,166.0,143.0
20152016,Nick Spaling,309,292,601,58,2,0.5141430948419301,58.0,84.0
20152016,Artem Anisimov,507,641,1148,77,2,0.4416376306620209,150.0,47.0
20152016,Joe Thornton,399,354,753,82,2,0.5298804780876494,38.0,65.0
20152016,Tomas Hertl,256,201,457,81,2,0.5601750547045952,15.0,94.0
20152016,Anze Kopitar,950,826,1776,81,2,0.5349099099099099,34.0,7.0
20152016,Tyler Seguin,470,376,846,72,2,0.5555555555555556,20.0,52.0
20152016,David Backes,620,572,1192,79,2,0.5201342281879194,49.0,25.0
20152016,John Tavares,741,629,1370,78,2,0.5408759124087591,30.0,15.0
20152016,Dennis Rasmussen,144,163,307,44,2,0.46905537459283386,125.0,128.0
20152016,Sean Monahan,887,852,1739,81,2,0.5100632547441059,65.0,9.0
20152016,Peter Holland,216,249,465,65,2,0.4645161290322581,128.0,106.0
20152016,Boyd Gordon,526,383,909,65,2,0.5786578657865786,5.0,43.0
20152016,Adam Lowry,391,454,845,74,2,0.46272189349112425,130.0,66.0
20152016,Andrew Shaw,146,168,314,78,2,0.46496815286624205,127.0,127.0
20152016,Chris Tierney,368,437,805,79,2,0.45714285714285713,139.0,75.0
20152016,Joe Pavelski,516,422,938,82,2,0.5501066098081023,25.0,45.0
20152016,Vincent Lecavalier,297,288,585,49,2,0.5076923076923077,68.0,86.0
20152016,Mike Richards,235,240,475,39,2,0.49473684210526314,87.0,98.0
20152016,Claude Giroux,1081,800,1881,78,2,0.5746943115364168,8.0,2.0
20152016,Teuvo Teravainen,125,184,309,78,2,0.4045307443365696,164.0,138.0
20152016,Mikhail Grigorenko,151,198,349,74,2,0.4326647564469914,155.0,125.0
20152016,Patrick Marleau,267,258,525,82,2,0.5085714285714286,67.0,93.0
20152016,Mike Ribeiro,288,472,760,81,2,0.37894736842105264,168.0,88.0
20152016,Jared McCann,181,341,522,69,2,0.34674329501915707,171.0,116.0
20152016,Joonas Kemppainen,227,232,459,44,2,0.49455337690631807,90.0,102.0
20152016,Riley Sheahan,358,424,782,81,2,0.4578005115089514,137.0,77.0
20152016,Mike Santorelli,75,83,158,70,2,0.47468354430379744,117.0,152.0
20152016,Jonathan Toews,921,652,1573,80,2,0.5855054036872218,1.0,8.0
20152016,Vincent Trocheck,547,559,1106,76,2,0.4945750452079566,89.0,37.0
20152016,Jay McClement,375,303,678,77,2,0.5530973451327433,23.0,71.0
20152016,Jori Lehtera,485,484,969,79,2,0.500515995872033,80.0,48.0
20152016,Mikael Granlund,528,557,1085,82,2,0.48663594470046084,102.0,42.0
20152016,Travis Zajac,715,672,1387,74,2,0.5155010814708003,55.0,16.0
20152016,Michael Latta,102,96,198,43,2,0.5151515151515151,57.0,144.0
20152016,David Krejci,560,557,1117,72,2,0.5013428827215757,78.0,36.0
20152016,Nathan MacKinnon,507,540,1047,72,2,0.48424068767908307,107.0,47.0
20152016,Cody Eakin,567,621,1188,82,2,0.4772727272727273,113.0,35.0
20152016,Sean Couturier,537,568,1105,63,2,0.485972850678733,103.0,40.0
20152016,Jussi Jokinen,135,127,262,81,2,0.5152671755725191,56.0,134.0
20152016,Cedric Paquette,141,142,283,56,2,0.49823321554770317,83.0,130.0
20152016,Chris Wagner,148,126,274,43,2,0.5401459854014599,32.0,126.0
20152016,Michael McCarron,85,84,169,20,2,0.5029585798816568,74.0,149.0
20152016,Radek Faksa,197,204,401,45,2,0.4912718204488778,95.0,111.0
20152016,Phillip Danault,247,272,519,51,2,0.47591522157996147,114.0,97.0
20152016,Mika Zibanejad,659,647,1306,81,2,0.5045941807044411,72.0,21.0
20152016,Vladislav Namestnikov,175,216,391,80,2,0.4475703324808184,145.0,117.0
20152016,Mikko Koivu,987,771,1758,82,2,0.5614334470989761,13.0,4.0
20152016,Mattias Janmark,94,166,260,73,2,0.36153846153846153,169.0,147.0
20152016,Nicklas Backstrom,659,698,1357,75,2,0.48563006632277084,105.0,21.0
20152016,Alex Wennberg,400,522,922,69,2,0.43383947939262474,154.0,64.0
20152016,Mathieu Perreault,94,109,203,71,2,0.4630541871921182,129.0,147.0
20152016,Kyle Turris,536,508,1044,57,2,0.5134099616858238,59.0,41.0
20152016,Antoine Vermette,754,597,1351,76,2,0.5581051073279053,18.0,14.0
20152016,Matt Cullen,582,462,1044,82,2,0.5574712643678161,19.0,33.0
20152016,Scott Laughton,170,218,388,71,2,0.4381443298969072,151.0,118.0
20152016,Nazem Kadri,641,663,1304,76,2,0.4915644171779141,92.0,23.0
20152016,Brian Boyle,346,336,682,76,2,0.5073313782991202,69.0,78.0
20152016,Jamie Benn,226,252,478,82,2,0.47280334728033474,119.0,103.0
20152016,Ryan Spooner,304,407,711,80,2,0.42756680731364277,158.0,85.0
20152016,Carl Soderberg,339,380,719,82,2,0.4714881780250348,122.0,79.0
20152016,Valtteri Filppula,632,584,1216,76,2,0.5197368421052632,50.0,24.0
20152016,Nick Bonino,463,455,918,63,2,0.5043572984749455,73.0,54.0
20152016,Byron Froese,310,332,642,56,2,0.48286604361370716,109.0,83.0
20152016,Brad Richards,124,126,250,68,2,0.496,85.0,139.0
20152016,Curtis Lazar,168,216,384,76,2,0.4375,152.0,119.0
20152016,Jarret Stoll,481,362,843,80,2,0.5705812574139977,10.0,49.0
20152016,Dominic Moore,476,385,861,80,2,0.5528455284552846,24.0,51.0
20152016,Scott Gomez,125,152,277,34,2,0.45126353790613716,143.0,138.0
20152016,Josh Jooris,114,143,257,59,2,0.44357976653696496,148.0,140.0
20152016,Tyler Johnson,125,161,286,17,3,0.4370629370629371,63.0,10.0
20152016,Pierre-Edouard Bellemare,31,31,62,5,3,0.5,37.0,41.0
20152016,T.J. Oshie,35,24,59,12,3,0.5932203389830508,6.0,37.0
20152016,Evgeny Kuznetsov,87,89,176,12,3,0.4943181818181818,39.0,20.0
20152016,Ryan White,18,12,30,6,3,0.6,3.0,49.0
20152016,Erik Haula,41,48,89,5,3,0.4606741573033708,59.0,36.0
20152016,Kyle Brodziak,52,45,97,20,3,0.5360824742268041,19.0,29.0
20152016,Jaden Schwartz,25,26,51,20,3,0.49019607843137253,42.0,46.0
20152016,Henrik Zetterberg,30,27,57,5,3,0.5263157894736842,22.0,42.0
20152016,Casey Cizikas,77,70,147,11,3,0.5238095238095238,24.0,23.0
20152016,Derick Brassard,46,42,88,5,3,0.5227272727272727,25.0,32.0
20152016,Pavel Datsyuk,42,45,87,5,3,0.4827586206896552,48.0,35.0
20152016,Patrik Berglund,48,54,102,20,3,0.47058823529411764,54.0,30.0
20152016,Nate Thompson,23,29,52,7,3,0.4423076923076923,62.0,47.0
20152016,Charlie Coyle,33,37,70,6,3,0.4714285714285714,53.0,39.0
20152016,Calle Jarnkrok,29,36,65,14,3,0.4461538461538462,61.0,43.0
20152016,Ryan Kesler,97,75,172,7,3,0.563953488372093,13.0,18.0
20152016,Sidney Crosby,295,268,563,24,3,0.5239786856127886,23.0,1.0
20152016,Frans Nielsen,77,65,142,11,3,0.5422535211267606,17.0,23.0
20152016,Nick Bjugstad,44,51,95,5,3,0.4631578947368421,57.0,33.0
20152016,Marcus Kruger,48,50,98,7,3,0.4897959183673469,43.0,30.0
20152016,Brock Nelson,52,63,115,11,3,0.45217391304347826,60.0,29.0
20152016,Aleksander Barkov,80,71,151,6,3,0.5298013245033113,21.0,22.0
20152016,Derek MacKenzie,52,43,95,6,3,0.5473684210526316,15.0,29.0
20152016,Colton Sissons,32,30,62,10,3,0.5161290322580645,29.0,40.0
20152016,Brayden Schenn,16,17,33,6,3,0.48484848484848486,46.0,50.0
20152016,Paul Stastny,255,181,436,20,3,0.5848623853211009,9.0,2.0
20152016,Luke Glendening,55,45,100,5,3,0.55,14.0,27.0
20152016,Jeff Carter,44,45,89,5,3,0.4943820224719101,38.0,33.0
20152016,Logan Couture,127,167,294,24,3,0.43197278911564624,65.0,9.0
20152016,Paul Gaustad,85,58,143,14,3,0.5944055944055944,5.0,21.0
20152016,Ryan Getzlaf,52,45,97,7,3,0.5360824742268041,19.0,29.0
20152016,Jarret Stoll,13,22,35,4,3,0.37142857142857144,70.0,52.0
20152016,Shawn Horcoff,16,18,34,5,3,0.47058823529411764,54.0,50.0
20152016,Derek Stepan,43,44,87,5,3,0.4942528735632184,40.0,34.0
20152016,Vernon Fiddler,47,49,96,13,3,0.4895833333333333,44.0,31.0
20152016,Jason Spezza,94,103,197,13,3,0.47715736040609136,51.0,19.0
20152016,Joel Ward,54,84,138,24,3,0.391304347826087,68.0,28.0
20152016,Rickard Rakell,29,20,49,7,3,0.5918367346938775,7.0,43.0
20152016,Jonathan Toews,110,77,187,7,3,0.5882352941176471,8.0,12.0
20152016,Vincent Trocheck,28,38,66,2,3,0.42424242424242425,66.0,44.0
20152016,Radek Faksa,106,104,210,13,3,0.5047619047619047,36.0,14.0
20152016,Vladislav Namestnikov,56,61,117,17,3,0.47863247863247865,50.0,26.0
20152016,Mikko Koivu,102,78,180,6,3,0.5666666666666667,12.0,16.0
20152016,Nicklas Backstrom,109,120,229,12,3,0.4759825327510917,52.0,13.0
20152016,Alan Quine,23,30,53,10,3,0.4339622641509434,64.0,47.0
20152016,David Backes,101,115,216,20,3,0.4675925925925926,55.0,17.0
20152016,John Tavares,123,94,217,11,3,0.5668202764976958,11.0,11.0
20152016,Mike Ribeiro,27,46,73,12,3,0.3698630136986301,71.0,45.0
20152016,Riley Sheahan,16,18,34,5,3,0.47058823529411764,54.0,50.0
20152016,Cedric Paquette,12,19,31,17,3,0.3870967741935484,69.0,53.0
20152016,Jay Beagle,94,80,174,12,3,0.5402298850574713,18.0,19.0
20152016,Mike Fisher,141,134,275,14,3,0.5127272727272727,32.0,7.0
20152016,Alexander Steen,29,69,98,20,3,0.29591836734693877,73.0,43.0
20152016,Vincent Lecavalier,42,27,69,5,3,0.6086956521739131,2.0,35.0
20152016,Claude Giroux,77,75,152,6,3,0.506578947368421,35.0,23.0
20152016,Teuvo Teravainen,14,26,40,7,3,0.35,72.0,51.0
20152016,Ryan Johansen,105,100,205,14,3,0.5121951219512195,33.0,15.0
20152016,Patrick Marleau,44,51,95,24,3,0.4631578947368421,57.0,33.0
20152016,Mike Richards,61,66,127,12,3,0.48031496062992124,49.0,25.0
20152016,Brian Boyle,106,110,216,17,3,0.49074074074074076,41.0,14.0
20152016,Valtteri Filppula,190,174,364,17,3,0.521978021978022,27.0,5.0
20152016,Nick Bonino,199,211,410,24,3,0.4853658536585366,45.0,4.0
20152016,Nick Cousins,22,15,37,6,3,0.5945945945945946,4.0,48.0
20152016,Evgeni Malkin,110,117,227,23,3,0.4845814977973568,47.0,12.0
20152016,Nick Spaling,56,65,121,24,3,0.4628099173553719,58.0,26.0
20152016,Jori Lehtera,125,120,245,20,3,0.5102040816326531,34.0,10.0
20152016,Cody Eakin,136,114,250,13,3,0.544,16.0,8.0
20152016,Eric Staal,46,28,74,5,3,0.6216216216216216,1.0,32.0
20152016,Brad Richards,14,16,30,5,3,0.4666666666666667,56.0,51.0
20152016,Dominic Moore,34,32,66,5,3,0.5151515151515151,30.0,38.0
20152016,Artem Anisimov,43,63,106,7,3,0.4056603773584906,67.0,34.0
20152016,Joe Thornton,127,120,247,24,3,0.5141700404858299,31.0,9.0
20152016,Anze Kopitar,71,52,123,5,3,0.5772357723577236,10.0,24.0
20152016,Andrew Shaw,23,20,43,6,3,0.5348837209302325,20.0,47.0
20152016,Chris Tierney,123,144,267,24,3,0.4606741573033708,59.0,11.0
20152016,Joe Pavelski,176,161,337,24,3,0.5222551928783383,26.0,6.0
20152016,Matt Cullen,205,188,393,24,3,0.5216284987277354,28.0,3.0
20162017,Tyler Johnson,583,539,1122,66,2,0.5196078431372549,51.0,45.0
20162017,Pierre-Edouard Bellemare,402,429,831,82,2,0.48375451263537905,101.0,71.0
20162017,T.J. Oshie,87,93,180,68,2,0.48333333333333334,102.0,158.0
20162017,Evgeny Kuznetsov,456,581,1037,82,2,0.43972999035679844,149.0,60.0
20162017,Zack Smith,317,292,609,74,2,0.5205254515599343,48.0,88.0
20162017,Erik Haula,404,346,750,72,2,0.5386666666666666,33.0,70.0
20162017,Johan Larsson,261,272,533,36,2,0.4896810506566604,98.0,99.0
20162017,Kevin Hayes,442,526,968,76,2,0.45661157024793386,135.0,63.0
20162017,Kyle Brodziak,323,330,653,69,2,0.4946401225114854,89.0,87.0
20162017,Ryan O'Reilly,1039,752,1791,72,2,0.5801228364042434,5.0,2.0
20162017,Henrik Zetterberg,705,657,1362,82,2,0.5176211453744494,53.0,25.0
20162017,Nicholas Shore,362,359,721,70,2,0.5020804438280166,80.0,80.0
20162017,Casey Cizikas,420,426,846,59,2,0.49645390070921985,87.0,66.0
20162017,Darren Helm,216,204,420,50,2,0.5142857142857142,62.0,111.0
20162017,Ryan Nugent-Hopkins,556,712,1268,82,2,0.4384858044164038,151.0,49.0
20162017,Matt Hendricks,132,100,232,42,2,0.5689655172413793,9.0,137.0
20162017,Patrik Berglund,584,585,1169,82,2,0.49957228400342174,85.0,44.0
20162017,Nick Schmaltz,84,188,272,61,2,0.3088235294117647,181.0,160.0
20162017,Patrice Bergeron,1089,723,1812,79,2,0.6009933774834437,3.0,1.0
20162017,Elias Lindholm,353,282,635,72,2,0.5559055118110237,16.0,83.0
20162017,Charlie Coyle,114,134,248,82,2,0.4596774193548387,133.0,145.0
20162017,Frans Nielsen,653,561,1214,79,2,0.5378912685337727,34.0,33.0
20162017,Tommy Wingels,111,149,260,73,2,0.4269230769230769,161.0,146.0
20162017,Nate Thompson,130,115,245,30,2,0.5306122448979592,38.0,138.0
20162017,Nic Petan,145,170,315,54,2,0.4603174603174603,132.0,132.0
20162017,Calle Jarnkrok,452,463,915,81,2,0.49398907103825135,90.0,61.0
20162017,Victor Rask,457,461,918,82,2,0.49782135076252726,86.0,59.0
20162017,Ryan Kesler,1029,764,1793,82,2,0.5738984941438929,8.0,3.0
20162017,Sidney Crosby,842,906,1748,75,2,0.4816933638443936,106.0,9.0
20162017,Matt Duchene,687,411,1098,77,2,0.6256830601092896,1.0,29.0
20162017,Steven Stamkos,106,92,198,17,2,0.5353535353535354,36.0,147.0
20162017,Sam Gagner,202,223,425,81,2,0.4752941176470588,116.0,115.0
20162017,Pavel Zacha,184,273,457,70,2,0.4026258205689278,173.0,122.0
20162017,Nick Bjugstad,186,205,391,54,2,0.47570332480818417,114.0,121.0
20162017,Jonathan Drouin,96,124,220,73,2,0.43636363636363634,154.0,151.0
20162017,Ben Smith,241,227,468,40,2,0.5149572649572649,59.0,102.0
20162017,Oscar Lindberg,299,276,575,65,2,0.52,49.0,92.0
20162017,Riley Nash,276,286,562,81,2,0.49110320284697506,94.0,95.0
20162017,Zemgus Girgensons,273,306,579,75,2,0.47150259067357514,120.0,97.0
20162017,Colton Sissons,192,192,384,58,2,0.5,83.0,120.0
20162017,Mikael Backlund,711,768,1479,81,2,0.48073022312373226,107.0,24.0
20162017,Brayden Schenn,232,262,494,79,2,0.46963562753036436,124.0,106.0
20162017,Derek Stepan,716,806,1522,81,2,0.4704336399474376,122.0,23.0
20162017,John Mitchell,298,240,538,65,2,0.5539033457249071,17.0,93.0
20162017,Jacob Josefson,162,151,313,38,2,0.5175718849840255,54.0,128.0
20162017,Blake Comeau,114,132,246,77,2,0.4634146341463415,129.0,145.0
20162017,Drake Caggiula,117,167,284,60,2,0.4119718309859155,168.0,143.0
20162017,Tomas Plekanec,692,660,1352,78,2,0.5118343195266272,69.0,27.0
20162017,Boone Jenner,92,92,184,82,2,0.5,83.0,154.0
20162017,Brandon Dubinsky,770,718,1488,80,2,0.5174731182795699,55.0,16.0
20162017,David Desharnais,170,162,332,49,2,0.5120481927710844,68.0,125.0
20162017,Marcus Kruger,357,370,727,70,2,0.49105914718019256,95.0,81.0
20162017,Josh Jooris,222,228,450,54,2,0.49333333333333335,91.0,109.0
20162017,Andrew Shaw,239,199,438,68,2,0.545662100456621,28.0,103.0
20162017,Brandon Sutter,788,664,1452,81,2,0.5426997245179064,31.0,13.0
20162017,Steve Ott,153,125,278,53,2,0.5503597122302158,21.0,130.0
20162017,Jordan Martinook,460,577,1037,77,2,0.44358727097396333,147.0,58.0
20162017,Paul Stastny,786,624,1410,66,2,0.5574468085106383,14.0,14.0
20162017,Mark Letestu,452,444,896,78,2,0.5044642857142857,78.0,61.0
20162017,Joseph Blandisi,76,93,169,27,2,0.44970414201183434,142.0,164.0
20162017,Sergey Kalinin,72,102,174,43,2,0.41379310344827586,166.0,165.0
20162017,Bryan Little,610,487,1097,59,2,0.5560619872379216,15.0,39.0
20162017,Shane Doan,94,105,199,74,2,0.4723618090452261,119.0,153.0
20162017,Matt Stajan,385,383,768,81,2,0.5013020833333334,82.0,75.0
20162017,Lukas Sedlak,232,211,443,62,2,0.5237020316027088,43.0,106.0
20162017,Derek Grant,201,183,384,46,2,0.5234375,45.0,116.0
20162017,Mika Zibanejad,494,456,950,56,2,0.52,49.0,55.0
20162017,Connor McDavid,348,458,806,82,2,0.4317617866004963,158.0,84.0
20162017,Logan Couture,297,456,753,73,2,0.3944223107569721,176.0,94.0
20162017,Jack Eichel,310,486,796,61,2,0.38944723618090454,177.0,89.0
20162017,Tyler Bozak,774,592,1366,78,2,0.5666178623718887,10.0,15.0
20162017,Anthony Beauvillier,123,174,297,66,2,0.41414141414141414,165.0,139.0
20162017,Andrew Copp,95,97,192,64,2,0.4947916666666667,88.0,152.0
20162017,Greg McKegg,90,90,180,46,2,0.5,83.0,156.0
20162017,Teuvo Teravainen,193,220,413,81,2,0.46731234866828086,127.0,119.0
20162017,Jean-Gabriel Pageau,558,460,1018,82,2,0.5481335952848723,25.0,48.0
20162017,Sam Bennett,374,437,811,81,2,0.46115906288532676,130.0,77.0
20162017,Jay Beagle,624,483,1107,81,2,0.5636856368563685,12.0,36.0
20162017,Mike Fisher,703,577,1280,72,2,0.54921875,23.0,26.0
20162017,Brad Richardson,121,109,230,16,2,0.5260869565217391,41.0,141.0
20162017,Brock Nelson,346,445,791,81,2,0.43742098609355246,153.0,85.0
20162017,Aleksander Barkov,476,547,1023,61,2,0.46529814271749753,128.0,56.0
20162017,Lars Eller,416,467,883,81,2,0.4711211778029445,121.0,67.0
20162017,Luke Glendening,307,261,568,74,2,0.5404929577464789,32.0,90.0
20162017,Gabriel Dumont,133,109,242,39,2,0.5495867768595041,22.0,136.0
20162017,Ryan Getzlaf,509,503,1012,74,2,0.5029644268774703,79.0,54.0
20162017,Henrik Sedin,611,635,1246,82,2,0.49036918138041735,96.0,38.0
20162017,Mark Scheifele,635,826,1461,79,2,0.4346338124572211,156.0,35.0
20162017,Leon Draisaitl,476,496,972,82,2,0.4897119341563786,97.0,56.0
20162017,Yanni Gourde,60,103,163,20,2,0.36809815950920244,179.0,168.0
20162017,Vinnie Hinostroza,68,103,171,49,2,0.39766081871345027,175.0,166.0
20162017,J.T. Miller,157,200,357,82,2,0.43977591036414565,148.0,129.0
20162017,Jason Spezza,354,324,678,68,2,0.5221238938053098,46.0,82.0
20162017,Joel Ward,223,233,456,78,2,0.48903508771929827,99.0,108.0
20162017,Alex Galchenyuk,274,368,642,61,2,0.42679127725856697,162.0,96.0
20162017,Jordan Staal,689,477,1166,75,2,0.5909090909090909,4.0,28.0
20162017,Dominic Moore,357,297,654,82,2,0.5458715596330275,27.0,81.0
20162017,Leo Komarov,91,111,202,82,2,0.4504950495049505,141.0,155.0
20162017,Derek MacKenzie,386,386,772,82,2,0.5,83.0,74.0
20162017,Torrey Mitchell,410,342,752,78,2,0.5452127659574468,30.0,68.0
20162017,Sam Reinhart,86,124,210,79,2,0.4095238095238095,170.0,159.0
20162017,Jeff Carter,735,680,1415,82,2,0.519434628975265,52.0,22.0
20162017,Tanner Kero,209,262,471,47,2,0.4437367303609342,146.0,113.0
20162017,Adam Henrique,585,629,1214,82,2,0.4818780889621087,105.0,43.0
20162017,Auston Matthews,530,602,1132,82,2,0.46819787985865724,125.0,52.0
20162017,Derick Brassard,612,613,1225,81,2,0.4995918367346939,84.0,37.0
20162017,Bo Horvat,756,742,1498,81,2,0.5046728971962616,77.0,19.0
20162017,William Karlsson,435,525,960,81,2,0.453125,138.0,65.0
20162017,Alexander Steen,101,146,247,76,2,0.4089068825910931,171.0,149.0
20162017,Nick Cousins,89,128,217,60,2,0.41013824884792627,169.0,157.0
20162017,Evgeni Malkin,365,481,846,62,2,0.4314420803782506,159.0,79.0
20162017,Adrian Kempe,67,86,153,25,2,0.43790849673202614,152.0,167.0
20162017,Artem Anisimov,416,506,922,64,2,0.4511930585683297,140.0,67.0
20162017,Joe Thornton,375,362,737,79,2,0.508819538670285,72.0,76.0
20162017,Adam Cracknell,135,160,295,69,2,0.4576271186440678,134.0,135.0
20162017,Tomas Hertl,245,229,474,49,2,0.5168776371308017,57.0,101.0
20162017,Anze Kopitar,892,801,1693,76,2,0.5268753691671589,40.0,6.0
20162017,Tyler Seguin,401,385,786,82,2,0.510178117048346,71.0,72.0
20162017,Alan Quine,264,286,550,61,2,0.48,108.0,98.0
20162017,John Tavares,824,804,1628,77,2,0.5061425061425061,75.0,11.0
20162017,Dennis Rasmussen,165,205,370,68,2,0.44594594594594594,144.0,126.0
20162017,Sean Monahan,743,701,1444,82,2,0.5145429362880887,61.0,21.0
20162017,Eric Fehr,79,75,154,53,2,0.512987012987013,65.0,162.0
20162017,Adam Lowry,658,637,1295,82,2,0.5081081081081081,73.0,32.0
20162017,Chris Tierney,401,425,826,80,2,0.4854721549636804,100.0,72.0
20162017,Joe Pavelski,449,407,856,81,2,0.5245327102803738,42.0,62.0
20162017,Vernon Fiddler,370,319,689,59,2,0.5370101596516691,35.0,78.0
20162017,Nic Dowd,338,369,707,70,2,0.4780763790664781,113.0,86.0
20162017,Brian Boyle,303,278,581,75,2,0.5215146299483648,47.0,91.0
20162017,Claude Giroux,977,771,1748,82,2,0.5589244851258581,13.0,4.0
20162017,Ryan Johansen,803,669,1472,82,2,0.545516304347826,29.0,12.0
20162017,Mikhail Grigorenko,111,81,192,75,2,0.578125,6.0,146.0
20162017,Patrick Marleau,115,100,215,82,2,0.5348837209302325,37.0,144.0
20162017,Mike Ribeiro,183,261,444,46,2,0.41216216216216217,167.0,123.0
20162017,Ryan Strome,147,197,344,69,2,0.4273255813953488,160.0,131.0
20162017,Antoine Vermette,744,451,1195,72,2,0.6225941422594142,2.0,20.0
20162017,Michael Chaput,203,182,385,68,2,0.5272727272727272,39.0,114.0
20162017,Riley Sheahan,236,230,466,80,2,0.5064377682403434,74.0,105.0
20162017,Christian Dvorak,471,535,1006,78,2,0.46819085487077533,126.0,57.0
20162017,Jonathan Toews,852,700,1552,72,2,0.5489690721649485,24.0,8.0
20162017,Vincent Trocheck,835,829,1664,82,2,0.5018028846153846,81.0,10.0
20162017,Martin Hanzal,767,593,1360,71,2,0.5639705882352941,11.0,18.0
20162017,Carter Rowney,95,103,198,27,2,0.4797979797979798,110.0,152.0
20162017,Jay McClement,253,272,525,65,2,0.4819047619047619,104.0,100.0
20162017,Jori Lehtera,409,423,832,64,2,0.49158653846153844,92.0,69.0
20162017,Derek Ryan,391,316,707,67,2,0.553041018387553,18.0,73.0
20162017,Travis Zajac,884,733,1617,80,2,0.546691403834261,26.0,7.0
20162017,David Krejci,659,620,1279,82,2,0.5152462861610634,58.0,31.0
20162017,Nathan MacKinnon,769,752,1521,82,2,0.5055884286653517,76.0,17.0
20162017,Cody Eakin,524,477,1001,60,2,0.5234765234765235,44.0,53.0
20162017,Sean Couturier,587,479,1066,66,2,0.550656660412758,20.0,42.0
20162017,Alexander Burmistrov,178,259,437,49,2,0.4073226544622426,172.0,124.0
20162017,Brendan Gaunce,84,80,164,57,2,0.5121951219512195,67.0,160.0
20162017,J.T. Compher,78,86,164,21,2,0.47560975609756095,115.0,163.0
20162017,Jonathan Marchessault,122,148,270,75,2,0.45185185185185184,139.0,140.0
20162017,Cedric Paquette,200,234,434,58,2,0.4608294930875576,131.0,117.0
20162017,Michael Sgarbossa,138,176,314,38,2,0.4394904458598726,150.0,134.0
20162017,Michael McCarron,76,99,175,31,2,0.4342857142857143,157.0,164.0
20162017,Radek Faksa,590,632,1222,80,2,0.4828150572831424,103.0,41.0
20162017,Vladislav Namestnikov,209,271,480,74,2,0.4354166666666667,155.0,113.0
20162017,Mikko Koivu,938,761,1699,80,2,0.5520894643908181,19.0,5.0
20162017,Peter Holland,228,274,502,48,2,0.4541832669322709,136.0,107.0
20162017,Nicklas Backstrom,685,648,1333,82,2,0.5138784696174044,63.0,30.0
20162017,Alex Wennberg,609,676,1285,80,2,0.47392996108949415,118.0,40.0
20162017,Brayden Point,238,294,532,68,2,0.4473684210526316,143.0,104.0
20162017,Mathieu Perreault,97,92,189,65,2,0.5132275132275133,64.0,150.0
20162017,Phillip Danault,533,498,1031,82,2,0.5169738118331717,56.0,51.0
20162017,Kyle Turris,650,575,1225,78,2,0.5306122448979592,38.0,34.0
20162017,Evan Rodrigues,104,146,250,30,2,0.416,164.0,148.0
20162017,Blake Coleman,96,130,226,23,2,0.4247787610619469,163.0,151.0
20162017,Matt Cullen,440,419,859,72,2,0.5122235157159488,66.0,64.0
20162017,Nazem Kadri,544,590,1134,82,2,0.47971781305114636,111.0,50.0
20162017,Tyler Graovac,163,180,343,52,2,0.4752186588921283,117.0,127.0
20162017,Valtteri Filppula,556,606,1162,79,2,0.4784853700516351,112.0,49.0
20162017,Denis Malgin,67,117,184,47,2,0.3641304347826087,180.0,167.0
20162017,Jamie Benn,212,200,412,77,2,0.5145631067961165,60.0,112.0
20162017,Brandon Pirri,140,103,243,60,2,0.5761316872427984,7.0,133.0
20162017,Ryan Spooner,79,124,203,78,2,0.3891625615763547,178.0,162.0
20162017,Carl Soderberg,365,337,702,80,2,0.51994301994302,50.0,79.0
20162017,Eric Staal,577,597,1174,82,2,0.49148211243611584,93.0,47.0
20162017,Devin Shore,221,249,470,82,2,0.4702127659574468,123.0,110.0
20162017,Chris Kelly,223,278,501,82,2,0.44510978043912175,145.0,108.0
20162017,Frederik Gauthier,120,115,235,21,2,0.5106382978723404,70.0,142.0
20162017,Nick Bonino,582,631,1213,80,2,0.47980214344600164,109.0,46.0
20162017,Dylan Larkin,196,236,432,80,2,0.4537037037037037,137.0,118.0
20162017,Ivan Barbashev,83,124,207,30,2,0.40096618357487923,174.0,161.0
20162017,T.J. Oshie,23,30,53,13,3,0.4339622641509434,58.0,47.0
20162017,Evgeny Kuznetsov,83,105,188,13,3,0.44148936170212766,57.0,21.0
20162017,Zack Smith,96,102,198,19,3,0.48484848484848486,41.0,16.0
20162017,Kevin Hayes,102,95,197,12,3,0.5177664974619289,27.0,15.0
20162017,Kyle Brodziak,63,76,139,10,3,0.45323741007194246,53.0,28.0
20162017,Vladimir Sobotka,33,28,61,11,3,0.5409836065573771,19.0,41.0
20162017,Ryan Nugent-Hopkins,86,106,192,13,3,0.4479166666666667,56.0,20.0
20162017,Patrik Berglund,83,98,181,11,3,0.4585635359116022,52.0,21.0
20162017,Patrice Bergeron,87,73,160,6,3,0.54375,15.0,19.0
20162017,Chris Wagner,20,20,40,17,3,0.5,33.0,50.0
20162017,Nate Thompson,69,65,134,17,3,0.5149253731343284,28.0,26.0
20162017,Martin Hanzal,51,38,89,5,3,0.5730337078651685,8.0,31.0
20162017,Calle Jarnkrok,153,158,311,21,3,0.4919614147909968,36.0,10.0
20162017,Ryan Kesler,207,171,378,17,3,0.5476190476190477,13.0,2.0
20162017,Sidney Crosby,276,285,561,24,3,0.4919786096256685,35.0,1.0
20162017,Sam Gagner,15,26,41,5,3,0.36585365853658536,65.0,52.0
20162017,Brandon Dubinsky,46,44,90,5,3,0.5111111111111111,30.0,34.0
20162017,Marcus Kruger,20,33,53,4,3,0.37735849056603776,62.0,50.0
20162017,Mika Zibanejad,102,116,218,12,3,0.46788990825688076,48.0,15.0
20162017,Connor McDavid,39,70,109,13,3,0.3577981651376147,66.0,36.0
20162017,Lars Eller,77,94,171,13,3,0.4502923976608187,55.0,24.0
20162017,Dominic Moore,25,22,47,6,3,0.5319148936170213,21.0,45.0
20162017,Frederick Gaudreau,29,32,61,8,3,0.47540983606557374,44.0,43.0
20162017,Riley Nash,30,25,55,6,3,0.5454545454545454,14.0,42.0
20162017,Colton Sissons,129,135,264,22,3,0.48863636363636365,38.0,14.0
20162017,Mikael Backlund,44,43,87,4,3,0.5057471264367817,32.0,35.0
20162017,Andrew Shaw,11,24,35,5,3,0.3142857142857143,69.0,54.0
20162017,Paul Stastny,78,82,160,7,3,0.4875,40.0,23.0
20162017,Mark Letestu,90,109,199,13,3,0.45226130653266333,54.0,18.0
20162017,Oscar Lindberg,49,45,94,12,3,0.5212765957446809,25.0,33.0
20162017,Tanner Kero,23,16,39,4,3,0.5897435897435898,5.0,47.0
20162017,Ryan Getzlaf,143,126,269,17,3,0.5315985130111525,22.0,12.0
20162017,Leon Draisaitl,79,91,170,13,3,0.4647058823529412,51.0,22.0
20162017,Tyler Bozak,67,60,127,6,3,0.5275590551181102,23.0,27.0
20162017,Auston Matthews,34,34,68,6,3,0.5,33.0,40.0
20162017,Tomas Plekanec,73,57,130,6,3,0.5615384615384615,10.0,25.0
20162017,Logan Couture,22,23,45,6,3,0.4888888888888889,37.0,48.0
20162017,Derek Stepan,91,126,217,12,3,0.41935483870967744,60.0,17.0
20162017,Jean-Gabriel Pageau,184,155,339,19,3,0.5427728613569321,16.0,5.0
20162017,Sam Bennett,17,29,46,4,3,0.3695652173913043,64.0,51.0
20162017,Jay Beagle,79,65,144,13,3,0.5486111111111112,12.0,22.0
20162017,Mike Fisher,193,183,376,20,3,0.5132978723404256,29.0,4.0
20162017,Alexander Steen,13,27,40,10,3,0.325,68.0,53.0
20162017,Evgeni Malkin,151,171,322,25,3,0.468944099378882,47.0,11.0
20162017,David Desharnais,36,40,76,13,3,0.47368421052631576,46.0,38.0
20162017,Ivan Barbashev,21,30,51,6,3,0.4117647058823529,61.0,49.0
20162017,Derick Brassard,135,137,272,19,3,0.4963235294117647,34.0,13.0
20162017,William Karlsson,46,40,86,5,3,0.5348837209302325,20.0,34.0
20162017,Joel Ward,15,16,31,6,3,0.4838709677419355,42.0,52.0
20162017,Alex Galchenyuk,13,22,35,6,3,0.37142857142857144,63.0,53.0
20162017,J.T. Miller,13,18,31,12,3,0.41935483870967744,60.0,53.0
20162017,Mikko Koivu,77,43,120,5,3,0.6416666666666667,1.0,24.0
20162017,Nicklas Backstrom,135,148,283,13,3,0.47703180212014135,43.0,13.0
20162017,Alex Wennberg,35,47,82,5,3,0.4268292682926829,59.0,39.0
20162017,Phillip Danault,57,40,97,6,3,0.5876288659793815,6.0,29.0
20162017,Artem Anisimov,15,36,51,4,3,0.29411764705882354,70.0,52.0
20162017,Joe Thornton,20,21,41,4,3,0.4878048780487805,39.0,50.0
20162017,Tomas Hertl,52,31,83,6,3,0.6265060240963856,2.0,30.0
20162017,Carter Rowney,25,24,49,20,3,0.5102040816326531,31.0,45.0
20162017,Jori Lehtera,24,45,69,8,3,0.34782608695652173,67.0,46.0
20162017,David Krejci,13,18,31,3,3,0.41935483870967744,60.0,53.0
20162017,Jonathan Toews,50,40,90,4,3,0.5555555555555556,11.0,32.0
20162017,Vernon Fiddler,27,31,58,9,3,0.46551724137931033,49.0,44.0
20162017,Steve Ott,20,23,43,6,3,0.46511627906976744,50.0,50.0
20162017,Sean Monahan,37,41,78,4,3,0.47435897435897434,45.0,37.0
20162017,Joe Pavelski,34,24,58,6,3,0.5862068965517241,7.0,40.0
20162017,Chris Tierney,20,21,41,6,3,0.4878048780487805,39.0,50.0
20162017,Ryan Johansen,165,139,304,14,3,0.5427631578947368,17.0,9.0
20162017,Antoine Vermette,183,118,301,17,3,0.6079734219269103,4.0,6.0
20162017,Brian Boyle,49,30,79,6,3,0.620253164556962,3.0,33.0
20162017,Kyle Turris,197,166,363,19,3,0.5426997245179064,18.0,3.0
20162017,Matt Cullen,180,139,319,25,3,0.5642633228840125,9.0,7.0
20162017,Nazem Kadri,49,45,94,6,3,0.5212765957446809,25.0,33.0
20162017,Nick Bonino,172,157,329,21,3,0.5227963525835866,24.0,8.0
20162017,Eric Staal,37,34,71,5,3,0.5211267605633803,26.0,37.0
20172018,Tyler Johnson,360,359,719,81,2,0.5006954102920723,91.0,84.0
20172018,T.J. Oshie,101,110,211,74,2,0.4786729857819905,112.0,145.0
20172018,Byron Froese,156,196,352,48,2,0.4431818181818182,147.0,132.0
20172018,Evgeny Kuznetsov,450,568,1018,79,2,0.44204322200392926,150.0,61.0
20172018,Zack Smith,297,323,620,68,2,0.4790322580645161,111.0,95.0
20172018,Ryan Carpenter,200,198,398,52,2,0.5025125628140703,90.0,119.0
20172018,Johan Larsson,348,291,639,80,2,0.5446009389671361,30.0,88.0
20172018,Kevin Hayes,562,550,1112,76,2,0.5053956834532374,85.0,34.0
20172018,Kyle Brodziak,504,463,967,81,2,0.5211995863495347,59.0,46.0
20172018,Ryan O'Reilly,1274,850,2124,81,2,0.5998116760828626,2.0,1.0
20172018,Henrik Zetterberg,666,709,1375,82,2,0.4843636363636364,104.0,22.0
20172018,Zach Hyman,72,96,168,82,2,0.42857142857142855,162.0,164.0
20172018,Valtteri Filppula,487,463,950,81,2,0.5126315789473684,73.0,51.0
20172018,Nick Foligno,340,401,741,72,2,0.45883940620782726,130.0,89.0
20172018,Casey Cizikas,473,418,891,64,2,0.5308641975308642,44.0,55.0
20172018,Vladimir Sobotka,191,161,352,81,2,0.5426136363636364,34.0,122.0
20172018,Joel Eriksson Ek,201,271,472,75,2,0.4258474576271186,163.0,118.0
20172018,Ryan Nugent-Hopkins,374,393,767,62,2,0.4876140808344198,102.0,83.0
20172018,Jonathan Drouin,447,604,1051,77,2,0.4253092293054234,165.0,63.0
20172018,Derek Stepan,740,810,1550,82,2,0.4774193548387097,114.0,14.0
20172018,Patrik Berglund,173,141,314,57,2,0.5509554140127388,20.0,126.0
20172018,Nick Schmaltz,321,480,801,78,2,0.40074906367041196,176.0,91.0
20172018,Patrice Bergeron,784,584,1368,64,2,0.5730994152046783,7.0,12.0
20172018,Mark Letestu,473,414,887,80,2,0.5332581736189402,42.0,55.0
20172018,Elias Lindholm,432,361,793,81,2,0.544766708701135,29.0,65.0
20172018,Nick Cousins,84,140,224,71,2,0.375,183.0,156.0
20172018,Tomas Plekanec,659,577,1236,77,2,0.5331715210355987,43.0,24.0
20172018,Charlie Coyle,240,220,460,66,2,0.5217391304347826,56.0,105.0
20172018,Frans Nielsen,483,558,1041,79,2,0.46397694524495675,125.0,53.0
20172018,Barclay Goodrow,154,108,262,47,2,0.5877862595419847,3.0,133.0
20172018,Matt Cullen,355,350,705,79,2,0.5035460992907801,89.0,85.0
20172018,Calle Jarnkrok,266,253,519,68,2,0.51252408477842,74.0,100.0
20172018,Victor Rask,393,323,716,71,2,0.5488826815642458,24.0,76.0
20172018,Nicholas Shore,352,386,738,64,2,0.47696476964769646,116.0,86.0
20172018,Matt Duchene,717,637,1354,82,2,0.5295420974889217,47.0,16.0
20172018,Vladislav Namestnikov,285,337,622,81,2,0.45819935691318325,132.0,97.0
20172018,Nate Thompson,360,278,638,69,2,0.5642633228840125,10.0,84.0
20172018,David Desharnais,386,315,701,71,2,0.550641940085592,22.0,78.0
20172018,Riley Sheahan,560,473,1033,81,2,0.542110358180058,35.0,35.0
20172018,Boo Nieves,97,122,219,28,2,0.4429223744292237,148.0,147.0
20172018,Jordan Staal,757,581,1338,79,2,0.5657698056801196,8.0,13.0
20172018,Leo Komarov,112,100,212,74,2,0.5283018867924528,52.0,140.0
20172018,Derek MacKenzie,315,290,605,75,2,0.5206611570247934,60.0,93.0
20172018,Ryan Getzlaf,406,443,849,56,2,0.47820965842167257,113.0,71.0
20172018,Henrik Sedin,438,504,942,82,2,0.46496815286624205,122.0,64.0
20172018,Mark Scheifele,594,565,1159,60,2,0.5125107851596203,75.0,29.0
20172018,Leon Draisaitl,672,526,1198,78,2,0.5609348914858097,11.0,21.0
20172018,Yanni Gourde,158,206,364,82,2,0.4340659340659341,158.0,130.0
20172018,Derick Brassard,516,534,1050,72,2,0.49142857142857144,99.0,44.0
20172018,Jared McCann,212,338,550,68,2,0.38545454545454544,179.0,114.0
20172018,Brayden Schenn,660,714,1374,82,2,0.48034934497816595,109.0,23.0
20172018,Jason Spezza,417,330,747,78,2,0.5582329317269076,14.0,69.0
20172018,Adam Henrique,508,547,1055,81,2,0.4815165876777251,107.0,45.0
20172018,Joel Ward,107,124,231,52,2,0.46320346320346323,127.0,141.0
20172018,Evander Kane,120,150,270,78,2,0.4444444444444444,146.0,138.0
20172018,Sebastian Aho,78,94,172,78,2,0.45348837209302323,137.0,158.0
20172018,Ryan Kesler,400,350,750,44,2,0.5333333333333333,41.0,73.0
20172018,Sidney Crosby,1026,909,1935,82,2,0.5302325581395348,45.0,2.0
20172018,Nick Bjugstad,152,146,298,82,2,0.5100671140939598,80.0,134.0
20172018,Steven Stamkos,466,426,892,78,2,0.5224215246636771,55.0,57.0
20172018,Pavel Zacha,318,407,725,69,2,0.4386206896551724,153.0,92.0
20172018,Josh Jooris,75,88,163,40,2,0.4601226993865031,129.0,161.0
20172018,Riley Nash,459,490,949,76,2,0.48366701791359323,105.0,60.0
20172018,Colton Sissons,517,418,935,81,2,0.5529411764705883,19.0,43.0
20172018,Mikael Backlund,705,705,1410,82,2,0.5,92.0,19.0
20172018,Jussi Jokinen,101,86,187,60,2,0.5401069518716578,38.0,145.0
20172018,Auston Matthews,375,313,688,62,2,0.5450581395348837,28.0,82.0
20172018,Bo Horvat,712,612,1324,64,2,0.5377643504531722,39.0,17.0
20172018,Cody Eakin,479,440,919,80,2,0.5212187159956474,58.0,54.0
20172018,Jonathan Marchessault,264,343,607,77,2,0.43492586490939045,157.0,101.0
20172018,Max Domi,185,227,412,82,2,0.44902912621359226,142.0,123.0
20172018,Alex Tuch,70,95,165,78,2,0.42424242424242425,166.0,166.0
20172018,Blake Wheeler,166,196,362,81,2,0.4585635359116022,131.0,127.0
20172018,Oskar Sundqvist,144,179,323,42,2,0.4458204334365325,145.0,135.0
20172018,Brandon Dubinsky,521,431,952,62,2,0.5472689075630253,27.0,42.0
20172018,Greg McKegg,115,118,233,26,2,0.49356223175965663,96.0,139.0
20172018,Martin Hanzal,239,195,434,38,2,0.5506912442396313,21.0,106.0
20172018,Jeff Carter,222,176,398,27,2,0.5577889447236181,15.0,111.0
20172018,David Perron,96,142,238,70,2,0.40336134453781514,174.0,148.0
20172018,David Backes,125,117,242,57,2,0.5165289256198347,65.0,137.0
20172018,Blake Comeau,104,167,271,79,2,0.3837638376383764,181.0,144.0
20172018,Boone Jenner,268,215,483,75,2,0.5548654244306418,16.0,99.0
20172018,Patrick Marleau,157,144,301,82,2,0.521594684385382,57.0,131.0
20172018,Rickard Rakell,105,121,226,77,2,0.4646017699115044,124.0,143.0
20172018,Lukas Sedlak,191,180,371,53,2,0.5148247978436657,68.0,122.0
20172018,Jacob Josefson,141,179,320,39,2,0.440625,152.0,136.0
20172018,Mika Zibanejad,654,633,1287,72,2,0.5081585081585082,82.0,26.0
20172018,Michael Amadio,74,96,170,37,2,0.43529411764705883,156.0,162.0
20172018,Connor McDavid,376,533,909,82,2,0.4136413641364136,172.0,81.0
20172018,Andrew Shaw,177,149,326,51,2,0.5429447852760736,32.0,124.0
20172018,Brandon Sutter,570,532,1102,61,2,0.5172413793103449,64.0,33.0
20172018,Tim Schaller,76,90,166,82,2,0.4578313253012048,134.0,160.0
20172018,Dominic Moore,196,165,361,50,2,0.5429362880886427,33.0,120.0
20172018,Bryan Little,732,574,1306,82,2,0.5604900459418071,12.0,15.0
20172018,Matt Stajan,248,234,482,68,2,0.5145228215767634,69.0,104.0
20172018,Jujhar Khaira,174,209,383,69,2,0.45430809399477806,136.0,125.0
20172018,Brock Nelson,389,416,805,82,2,0.4832298136645963,106.0,77.0
20172018,Aleksander Barkov,908,789,1697,79,2,0.5350618738951091,40.0,5.0
20172018,Lars Eller,471,485,956,81,2,0.49267782426778245,98.0,56.0
20172018,Luke Glendening,394,285,679,69,2,0.5802650957290133,5.0,75.0
20172018,Tim Schaller,76,90,166,82,2,0.4578313253012048,134.0,160.0
20172018,Dominic Moore,196,165,361,50,2,0.5429362880886427,33.0,120.0
20172018,Bryan Little,732,574,1306,82,2,0.5604900459418071,12.0,15.0
20172018,Matt Stajan,248,234,482,68,2,0.5145228215767634,69.0,104.0
20172018,Jujhar Khaira,174,209,383,69,2,0.45430809399477806,136.0,125.0
20172018,Brock Nelson,389,416,805,82,2,0.4832298136645963,106.0,77.0
20172018,Aleksander Barkov,908,789,1697,79,2,0.5350618738951091,40.0,5.0
20172018,Lars Eller,471,485,956,81,2,0.49267782426778245,98.0,56.0
20172018,Luke Glendening,394,285,679,69,2,0.5802650957290133,5.0,75.0
20172018,Pierre-Edouard Bellemare,355,339,694,72,2,0.5115273775216138,78.0,85.0
20172018,Auston Matthews,375,313,688,62,2,0.5450581395348837,28.0,82.0
20172018,Bo Horvat,712,612,1324,64,2,0.5377643504531722,39.0,17.0
20172018,Cody Eakin,479,440,919,80,2,0.5212187159956474,58.0,54.0
20172018,Jonathan Marchessault,264,343,607,77,2,0.43492586490939045,157.0,101.0
20172018,Max Domi,185,227,412,82,2,0.44902912621359226,142.0,123.0
20172018,Alex Tuch,70,95,165,78,2,0.42424242424242425,166.0,166.0
20172018,Ryan Hartman,93,110,203,78,2,0.458128078817734,133.0,149.0
20172018,Evgeni Malkin,460,592,1052,78,2,0.4372623574144487,155.0,59.0
20172018,Torrey Mitchell,194,197,391,60,2,0.4961636828644501,95.0,121.0
20172018,Andreas Athanasiou,106,149,255,71,2,0.41568627450980394,171.0,142.0
20172018,Kyle Turris,449,423,872,76,2,0.5149082568807339,67.0,62.0
20172018,Dominic Toninato,83,116,199,37,2,0.41708542713567837,170.0,157.0
20172018,Adrian Kempe,263,420,683,81,2,0.3850658857979502,180.0,102.0
20172018,Ryan Spooner,91,119,210,59,2,0.43333333333333335,159.0,151.0
20172018,Anthony Cirelli,96,118,214,18,2,0.4485981308411215,143.0,148.0
20172018,Artem Anisimov,416,494,910,72,2,0.45714285714285713,135.0,70.0
20172018,Mathew Barzal,355,479,834,82,2,0.42565947242206237,164.0,85.0
20172018,Sean Kuraly,335,386,721,75,2,0.4646324549237171,123.0,90.0
20172018,Ryan Strome,297,374,671,82,2,0.4426229508196721,149.0,95.0
20172018,Joe Thornton,229,211,440,47,2,0.5204545454545455,61.0,109.0
20172018,Tomas Hertl,587,569,1156,79,2,0.5077854671280276,83.0,30.0
20172018,Charles Hudon,88,131,219,72,2,0.4018264840182648,175.0,153.0
20172018,Anze Kopitar,983,833,1816,82,2,0.5412995594713657,36.0,3.0
20172018,Tyler Seguin,790,650,1440,82,2,0.5486111111111112,26.0,11.0
20172018,Nico Hischier,422,561,983,82,2,0.42929806714140384,161.0,67.0
20172018,John Tavares,913,813,1726,82,2,0.5289687137891078,50.0,4.0
20172018,Pierre-Luc Dubois,461,591,1052,82,2,0.438212927756654,154.0,58.0
20172018,Sean Monahan,709,698,1407,74,2,0.503909026297086,88.0,18.0
20172018,Adam Lowry,375,296,671,45,2,0.5588673621460507,13.0,82.0
20172018,Chris Tierney,488,468,956,82,2,0.5104602510460251,79.0,50.0
20172018,Joe Pavelski,500,411,911,82,2,0.5488474204171241,25.0,48.0
20172018,Claude Giroux,638,450,1088,82,2,0.5863970588235294,4.0,27.0
20172018,Alexander Burmistrov,87,94,181,24,2,0.48066298342541436,108.0,154.0
20172018,Ryan Johansen,810,651,1461,79,2,0.5544147843942505,17.0,9.0
20172018,Gabriel Landeskog,215,203,418,78,2,0.5143540669856459,70.0,113.0
20172018,Antoine Vermette,609,406,1015,64,2,0.6,1.0,28.0
20172018,David Kampf,291,258,549,46,2,0.5300546448087432,46.0,96.0
20172018,Christian Dvorak,585,554,1139,78,2,0.5136084284460053,72.0,31.0
20172018,Jacob de la Rose,206,261,467,55,2,0.4411134903640257,151.0,117.0
20172018,William Karlsson,402,435,837,82,2,0.48028673835125446,110.0,72.0
20172018,Jonathan Toews,900,653,1553,74,2,0.5795235028976176,6.0,6.0
20172018,Vincent Trocheck,853,724,1577,82,2,0.5409004438807863,37.0,7.0
20172018,Paul Stastny,832,683,1515,82,2,0.5491749174917492,23.0,8.0
20172018,Carter Rowney,164,146,310,44,2,0.5290322580645161,49.0,128.0
20172018,Alex Kerfoot,207,285,492,79,2,0.42073170731707316,168.0,116.0
20172018,Travis Zajac,557,537,1094,63,2,0.5091407678244972,81.0,36.0
20172018,Derek Ryan,531,409,940,80,2,0.5648936170212766,9.0,39.0
20172018,David Krejci,502,465,967,64,2,0.5191313340227508,63.0,47.0
20172018,Nathan MacKinnon,485,672,1157,74,2,0.4191875540190147,169.0,52.0
20172018,Colton Sceviour,77,81,158,76,2,0.4873417721518987,103.0,159.0
20172018,Sean Couturier,529,472,1001,82,2,0.5284715284715285,51.0,40.0
20172018,Matt Hendricks,226,232,458,60,2,0.49344978165938863,97.0,110.0
20172018,J.T. Compher,273,332,605,69,2,0.4512396694214876,141.0,98.0
20172018,Connor Brown,59,93,152,82,2,0.3881578947368421,178.0,168.0
20172018,Cedric Paquette,234,265,499,56,2,0.46893787575150303,119.0,107.0
20172018,Brian Boyle,420,412,832,69,2,0.5048076923076923,87.0,68.0
20172018,Radek Faksa,556,521,1077,79,2,0.5162488393686165,66.0,37.0
20172018,Tyson Jost,84,145,229,65,2,0.36681222707423583,184.0,156.0
20172018,Mikko Koivu,809,766,1575,82,2,0.5136507936507937,71.0,10.0
20172018,Mattias Janmark,71,109,180,81,2,0.39444444444444443,177.0,165.0
20172018,Nicklas Backstrom,702,669,1371,81,2,0.5120350109409191,77.0,20.0
20172018,Alex Wennberg,350,424,774,66,2,0.45219638242894056,140.0,87.0
20172018,Brayden Point,557,617,1174,82,2,0.4744463373083475,117.0,36.0
20172018,Phillip Danault,380,340,720,52,2,0.5277777777777778,53.0,80.0
20172018,Evan Rodrigues,156,212,368,48,2,0.42391304347826086,167.0,132.0
20172018,Blake Coleman,252,285,537,79,2,0.4692737430167598,118.0,103.0
20172018,Scott Laughton,314,290,604,81,2,0.5198675496688742,62.0,94.0
20172018,Nazem Kadri,546,547,1093,80,2,0.49954254345837146,93.0,38.0
20172018,Marcus Kruger,159,128,287,48,2,0.554006968641115,18.0,129.0
20172018,Jamie Benn,381,345,726,82,2,0.5247933884297521,54.0,79.0
20172018,Carl Soderberg,425,514,939,77,2,0.45260915867944623,139.0,66.0
20172018,Eric Staal,571,544,1115,82,2,0.5121076233183857,76.0,32.0
20172018,Devin Shore,88,102,190,82,2,0.4631578947368421,128.0,153.0
20172018,Nolan Patrick,376,367,743,73,2,0.506056527590848,84.0,81.0
20172018,Oscar Lindberg,99,88,187,63,2,0.5294117647058824,48.0,146.0
20172018,Dylan Larkin,656,658,1314,82,2,0.4992389649923896,94.0,25.0
20172018,Nick Bonino,527,443,970,71,2,0.5432989690721649,31.0,41.0
20172018,Troy Brouwer,101,116,217,76,2,0.46543778801843316,121.0,145.0
20172018,Chris Wagner,230,240,470,79,2,0.48936170212765956,100.0,108.0
20172018,Mark Jankowski,395,415,810,72,2,0.4876543209876543,101.0,74.0
20172018,Erik Haula,489,479,968,76,2,0.5051652892561983,86.0,49.0
20172018,Markus Granlund,73,106,179,53,2,0.40782122905027934,173.0,163.0
20172018,Brendan Gallagher,85,97,182,82,2,0.46703296703296704,120.0,155.0
20172018,Logan Shaw,92,111,203,72,2,0.45320197044334976,138.0,150.0
20172018,Tommy Wingels,211,244,455,75,2,0.46373626373626375,126.0,115.0
20172018,Ivan Barbashev,61,98,159,53,2,0.3836477987421384,182.0,167.0
20172018,Dylan Strome,92,122,214,21,2,0.42990654205607476,160.0,150.0
20172018,Sam Gagner,220,241,461,74,2,0.4772234273318872,115.0,112.0
20172018,Daniel Winnik,89,110,199,81,2,0.4472361809045226,144.0,152.0
20172018,T.J. Oshie,33,35,68,24,3,0.4852941176470588,45.0,44.0
20172018,Evgeny Kuznetsov,124,201,325,24,3,0.38153846153846155,71.0,10.0
20172018,Evander Kane,16,23,39,9,3,0.41025641025641024,67.0,57.0
20172018,Eric Fehr,47,40,87,10,3,0.5402298850574713,19.0,37.0
20172018,Zach Hyman,13,22,35,7,3,0.37142857142857144,73.0,59.0
20172018,Tyler Johnson,95,79,174,17,3,0.5459770114942529,17.0,15.0
20172018,Nick Foligno,44,40,84,6,3,0.5238095238095238,28.0,39.0
20172018,Patrice Bergeron,152,117,269,11,3,0.5650557620817844,12.0,5.0
20172018,Valtteri Filppula,43,37,80,6,3,0.5375,21.0,40.0
20172018,Noel Acciari,12,18,30,12,3,0.4,70.0,60.0
20172018,Tomas Plekanec,50,63,113,7,3,0.4424778761061947,60.0,36.0
20172018,Matt Cullen,14,18,32,5,3,0.4375,61.0,58.0
20172018,Ryan Kesler,38,40,78,4,3,0.48717948717948717,44.0,41.0
20172018,Derick Brassard,62,63,125,12,3,0.496,39.0,32.0
20172018,Steven Stamkos,86,81,167,17,3,0.5149700598802395,34.0,19.0
20172018,Brandon Dubinsky,51,30,81,6,3,0.6296296296296297,3.0,35.0
20172018,Ryan Carpenter,68,64,132,17,3,0.5151515151515151,33.0,28.0
20172018,Pavel Zacha,21,38,59,5,3,0.3559322033898305,75.0,53.0
20172018,Sidney Crosby,151,132,283,12,3,0.5335689045936396,24.0,6.0
20172018,Lars Eller,167,163,330,24,3,0.5060606060606061,36.0,2.0
20172018,Riley Nash,69,50,119,9,3,0.5798319327731093,9.0,27.0
20172018,Colton Sissons,68,54,122,13,3,0.5573770491803278,14.0,28.0
20172018,Pierre-Edouard Bellemare,81,85,166,20,3,0.4879518072289157,43.0,21.0
20172018,Jeff Carter,27,38,65,4,3,0.4153846153846154,65.0,49.0
20172018,Ryan Getzlaf,31,29,60,4,3,0.5166666666666667,31.0,46.0
20172018,Mark Scheifele,153,169,322,17,3,0.4751552795031056,50.0,4.0
20172018,Tyler Bozak,57,43,100,7,3,0.57,11.0,34.0
20172018,Andrew Copp,29,30,59,16,3,0.4915254237288136,42.0,47.0
20172018,William Nylander,29,19,48,7,3,0.6041666666666666,5.0,47.0
20172018,Auston Matthews,43,35,78,7,3,0.5512820512820513,15.0,40.0
20172018,Bryan Little,99,98,197,17,3,0.5025380710659898,37.0,14.0
20172018,Cody Eakin,101,83,184,20,3,0.5489130434782609,16.0,13.0
20172018,Jonathan Marchessault,38,71,109,20,3,0.3486238532110092,77.0,41.0
20172018,Boone Jenner,17,15,32,6,3,0.53125,25.0,56.0
20172018,Jay Beagle,184,122,306,23,3,0.6013071895424836,7.0,1.0
20172018,Mike Fisher,78,42,120,12,3,0.65,2.0,23.0
20172018,Alex Tuch,33,44,77,20,3,0.42857142857142855,64.0,44.0
20172018,Evgeni Malkin,38,39,77,9,3,0.4935064935064935,40.0,41.0
20172018,J.T. Miller,76,70,146,17,3,0.5205479452054794,29.0,24.0
20172018,Adrian Kempe,11,19,30,4,3,0.36666666666666664,74.0,61.0
20172018,Anthony Cirelli,75,84,159,17,3,0.4716981132075472,52.0,25.0
20172018,Nate Thompson,28,8,36,4,3,0.7777777777777778,1.0,48.0
20172018,Sean Kuraly,38,55,93,12,3,0.40860215053763443,68.0,41.0
20172018,Nico Hischier,36,32,68,5,3,0.5294117647058824,27.0,43.0
20172018,Pierre-Luc Dubois,46,67,113,6,3,0.40707964601769914,69.0,38.0
20172018,Anze Kopitar,64,42,106,4,3,0.6037735849056604,6.0,30.0
20172018,Tomas Hertl,105,77,182,10,3,0.5769230769230769,10.0,12.0
20172018,Nolan Patrick,25,28,53,6,3,0.4716981132075472,52.0,51.0
20172018,Nick Bonino,87,76,163,13,3,0.5337423312883436,23.0,18.0
20172018,Daniel Winnik,17,22,39,5,3,0.4358974358974359,62.0,56.0
20172018,Erik Haula,134,130,264,20,3,0.5075757575757576,35.0,8.0
20172018,Adam Henrique,24,29,53,4,3,0.4528301886792453,56.0,52.0
20172018,Adam Lowry,94,103,197,17,3,0.47715736040609136,49.0,16.0
20172018,Chris Tierney,63,63,126,10,3,0.5,38.0,31.0
20172018,Joe Pavelski,79,69,148,10,3,0.5337837837837838,22.0,22.0
20172018,Nazem Kadri,17,24,41,4,3,0.4146341463414634,66.0,56.0
20172018,Carl Soderberg,31,32,63,6,3,0.49206349206349204,41.0,46.0
20172018,Eric Staal,46,28,74,5,3,0.6216216216216216,4.0,38.0
20172018,Claude Giroux,27,29,56,6,3,0.48214285714285715,48.0,49.0
20172018,Ryan Johansen,143,96,239,13,3,0.5983263598326359,8.0,7.0
20172018,Gabriel Landeskog,20,37,57,6,3,0.3508771929824561,76.0,54.0
20172018,Chandler Stephenson,37,45,82,24,3,0.45121951219512196,57.0,42.0
20172018,Cedric Paquette,109,93,202,17,3,0.5396039603960396,20.0,11.0
20172018,Kyle Turris,71,85,156,13,3,0.4551282051282051,55.0,26.0
20172018,Mikko Koivu,44,51,95,5,3,0.4631578947368421,53.0,39.0
20172018,Nicklas Backstrom,167,156,323,20,3,0.5170278637770898,30.0,2.0
20172018,Brayden Point,59,69,128,17,3,0.4609375,54.0,33.0
20172018,Brian Boyle,19,25,44,5,3,0.4318181818181818,63.0,55.0
20172018,Paul Stastny,130,115,245,17,3,0.5306122448979592,26.0,9.0
20172018,William Karlsson,160,170,330,20,3,0.48484848484848486,46.0,3.0
20172018,Riley Sheahan,90,71,161,12,3,0.5590062111801242,13.0,17.0
20172018,Travis Zajac,65,55,120,5,3,0.5416666666666666,18.0,29.0
20172018,David Krejci,85,105,190,12,3,0.4473684210526316,58.0,20.0
20172018,Mark Letestu,31,33,64,6,3,0.484375,47.0,46.0
20172018,J.T. Compher,28,35,63,6,3,0.4444444444444444,59.0,48.0
20172018,Sean Couturier,47,44,91,5,3,0.5164835164835165,32.0,37.0
20172018,Nathan MacKinnon,32,53,85,6,3,0.3764705882352941,72.0,45.0
20172018,Alex Kerfoot,26,29,55,6,3,0.4727272727272727,51.0,50.0
20182019,Tyler Johnson,230,243,473,80,2,0.48625792811839325,111.0,113.0
20182019,T.J. Oshie,84,121,205,69,2,0.4097560975609756,174.0,158.0
20182019,Leo Komarov,84,100,184,82,2,0.45652173913043476,144.0,158.0
20182019,Evgeny Kuznetsov,396,627,1023,76,2,0.3870967741935484,180.0,74.0
20182019,Zack Smith,403,417,820,70,2,0.49146341463414633,102.0,71.0
20182019,Kevin Rooney,187,192,379,41,2,0.49340369393139843,98.0,123.0
20182019,Matt Duchene,676,546,1222,73,2,0.5531914893617021,21.0,18.0
20182019,Travis Boyd,76,134,210,53,2,0.3619047619047619,186.0,162.0
20182019,Evander Kane,92,120,212,75,2,0.4339622641509434,161.0,154.0
20182019,Johan Larsson,503,490,993,73,2,0.5065458207452165,84.0,46.0
20182019,Eric Fehr,364,345,709,72,2,0.5133991537376587,69.0,79.0
20182019,Roope Hintz,217,183,400,58,2,0.5425,34.0,116.0
20182019,Zach Hyman,113,124,237,71,2,0.4767932489451477,122.0,144.0
20182019,Nick Foligno,133,102,235,73,2,0.5659574468085107,10.0,139.0
20182019,Jesperi Kotkaniemi,359,426,785,79,2,0.4573248407643312,141.0,82.0
20182019,Luke Kunin,88,112,200,49,2,0.44,156.0,156.0
20182019,Casey Mittelstadt,213,323,536,77,2,0.39738805970149255,177.0,117.0
20182019,Casey Cizikas,497,516,1013,73,2,0.4906219151036525,105.0,49.0
20182019,Ryan Nugent-Hopkins,379,461,840,82,2,0.4511904761904762,149.0,77.0
20182019,Charlie Coyle,322,380,702,81,2,0.4586894586894587,138.0,91.0
20182019,Joel Eriksson Ek,247,293,540,58,2,0.45740740740740743,140.0,108.0
20182019,Derek Stepan,651,725,1376,72,2,0.4731104651162791,131.0,21.0
20182019,Derick Brassard,283,305,588,70,2,0.4812925170068027,120.0,99.0
20182019,Patrice Bergeron,786,603,1389,65,2,0.5658747300215983,11.0,13.0
20182019,Kyle Brodziak,399,368,767,70,2,0.5202086049543677,60.0,72.0
20182019,Nick Cousins,243,277,520,81,2,0.4673076923076923,133.0,110.0
20182019,Frans Nielsen,450,473,923,72,2,0.4875406283856988,109.0,59.0
20182019,Noel Acciari,200,203,403,72,2,0.49627791563275436,93.0,121.0
20182019,Barclay Goodrow,296,255,551,82,2,0.5372050816696915,41.0,97.0
20182019,Elias Lindholm,509,428,937,81,2,0.5432230522945571,33.0,44.0
20182019,Calle Jarnkrok,166,165,331,79,2,0.5015105740181269,87.0,128.0
20182019,Ryan Kesler,582,463,1045,60,2,0.5569377990430622,16.0,31.0
20182019,Steven Stamkos,506,447,953,82,2,0.5309548793284365,48.0,45.0
20182019,Pavel Zacha,348,364,712,61,2,0.4887640449438202,108.0,85.0
20182019,Sidney Crosby,1012,814,1826,79,2,0.5542168674698795,20.0,5.0
20182019,Brian Boyle,170,163,333,73,2,0.5105105105105106,76.0,127.0
20182019,Tyler Bozak,451,379,830,72,2,0.5433734939759036,32.0,58.0
20182019,Colton Sissons,421,372,793,75,2,0.5308953341740227,49.0,68.0
20182019,Mikael Backlund,511,520,1031,77,2,0.495635305528613,94.0,43.0
20182019,Ryan Strome,365,402,767,81,2,0.4758800521512386,125.0,78.0
20182019,Jeff Carter,607,577,1184,76,2,0.512668918918919,71.0,26.0
20182019,Phil Varone,81,82,163,47,2,0.49693251533742333,91.0,159.0
20182019,David Backes,176,133,309,70,2,0.56957928802589,8.0,125.0
20182019,Sebastian Aho,585,619,1204,82,2,0.48588039867109634,112.0,30.0
20182019,Brayden Schenn,323,357,680,72,2,0.475,126.0,90.0
20182019,Jason Spezza,470,337,807,76,2,0.5824039653035935,1.0,54.0
20182019,Oskar Sundqvist,227,314,541,74,2,0.4195933456561922,169.0,114.0
20182019,Brandon Dubinsky,427,321,748,61,2,0.570855614973262,6.0,66.0
20182019,Marcus Kruger,188,203,391,74,2,0.48081841432225064,121.0,122.0
20182019,Jason Dickinson,201,268,469,67,2,0.42857142857142855,163.0,120.0
20182019,Andrew Shaw,181,203,384,63,2,0.4713541666666667,132.0,124.0
20182019,Brandon Sutter,224,238,462,26,2,0.48484848484848486,113.0,115.0
20182019,Ryan Getzlaf,551,463,1014,67,2,0.5433925049309665,31.0,36.0
20182019,Mark Scheifele,803,933,1736,82,2,0.46255760368663595,136.0,12.0
20182019,Leon Draisaitl,677,663,1340,82,2,0.505223880597015,85.0,17.0
20182019,Yanni Gourde,151,132,283,80,2,0.5335689045936396,46.0,133.0
20182019,Bo Horvat,1083,935,2018,82,2,0.5366699702675917,44.0,2.0
20182019,Jakob Forsbacka Karlsson,95,131,226,28,2,0.42035398230088494,168.0,153.0
20182019,Cody Eakin,479,461,940,78,2,0.5095744680851064,78.0,52.0
20182019,Mikael Granlund,129,159,288,79,2,0.4479166666666667,152.0,140.0
20182019,Jonathan Marchessault,92,155,247,82,2,0.3724696356275304,184.0,154.0
20182019,Adrian Kempe,315,424,739,81,2,0.42625169147496617,166.0,94.0
20182019,Riley Nash,150,183,333,78,2,0.45045045045045046,150.0,134.0
20182019,Ryan Carpenter,161,145,306,68,2,0.5261437908496732,54.0,130.0
20182019,Sam Steel,108,112,220,22,2,0.4909090909090909,103.0,146.0
20182019,Mika Zibanejad,831,842,1673,82,2,0.4967124925283921,92.0,11.0
20182019,Michael Amadio,96,127,223,43,2,0.4304932735426009,162.0,152.0
20182019,Connor McDavid,428,490,918,78,2,0.4662309368191721,134.0,65.0
20182019,Kevin Hayes,483,498,981,71,2,0.4923547400611621,100.0,51.0
20182019,Nick Bjugstad,262,268,530,64,2,0.49433962264150944,95.0,105.0
20182019,Jay Beagle,426,332,758,57,2,0.5620052770448549,13.0,67.0
20182019,Anders Lee,75,80,155,82,2,0.4838709677419355,117.0,163.0
20182019,Devin Shore,86,123,209,76,2,0.41148325358851673,172.0,157.0
20182019,Bryan Little,526,476,1002,82,2,0.5249500998003992,56.0,41.0
20182019,Filip Chytil,68,107,175,75,2,0.38857142857142857,178.0,164.0
20182019,Brock Nelson,594,652,1246,82,2,0.4767255216693419,123.0,27.0
20182019,Jordan Martinook,150,191,341,82,2,0.4398826979472141,157.0,134.0
20182019,Antti Suomela,102,127,229,27,2,0.44541484716157204,153.0,148.0
20182019,Aleksander Barkov,1041,898,1939,82,2,0.5368746776689015,43.0,4.0
20182019,Lars Eller,543,566,1109,81,2,0.4896302975653742,107.0,37.0
20182019,Justin Williams,92,150,242,82,2,0.38016528925619836,182.0,154.0
20182019,Greg McKegg,146,140,286,41,2,0.5104895104895105,77.0,136.0
20182019,Luke Glendening,658,524,1182,78,2,0.55668358714044,17.0,20.0
20182019,Pierre-Edouard Bellemare,394,326,720,76,2,0.5472222222222223,26.0,75.0
20182019,Victor Rask,204,226,430,49,2,0.4744186046511628,128.0,119.0
20182019,Auston Matthews,475,436,911,68,2,0.5214050493962679,59.0,53.0
20182019,John Tavares,832,696,1528,82,2,0.5445026178010471,30.0,10.0
20182019,Jean-Gabriel Pageau,259,222,481,39,2,0.5384615384615384,39.0,106.0
20182019,Brad Richardson,577,474,1051,66,2,0.5490009514747859,25.0,32.0
20182019,Evgeni Malkin,381,453,834,68,2,0.4568345323741007,143.0,76.0
20182019,Elias Pettersson,257,370,627,71,2,0.4098883572567783,173.0,107.0
20182019,Andreas Athanasiou,171,228,399,76,2,0.42857142857142855,163.0,126.0
20182019,Nic Dowd,245,227,472,64,2,0.5190677966101694,63.0,109.0
20182019,J.T. Miller,259,265,524,75,2,0.49427480916030536,96.0,106.0
20182019,Boo Nieves,88,139,227,43,2,0.3876651982378855,179.0,156.0
20182019,Nate Thompson,409,351,760,78,2,0.5381578947368421,40.0,69.0
20182019,Jordan Staal,571,452,1023,50,2,0.5581622678396871,15.0,34.0
20182019,Frederick Gaudreau,156,167,323,55,2,0.48297213622291024,119.0,132.0
20182019,Chris Tierney,531,512,1043,81,2,0.5091083413231065,80.0,38.0
20182019,Christoffer Ehn,84,93,177,60,2,0.4745762711864407,127.0,158.0
20182019,Pierre-Edouard Bellemare,394,326,720,76,2,0.5472222222222223,26.0,75.0
20182019,Victor Rask,204,226,430,49,2,0.4744186046511628,128.0,119.0
20182019,Auston Matthews,475,436,911,68,2,0.5214050493962679,59.0,53.0
20182019,John Tavares,832,696,1528,82,2,0.5445026178010471,30.0,10.0
20182019,Robert Thomas,97,123,220,70,2,0.4409090909090909,155.0,151.0
20182019,Boone Jenner,626,531,1157,77,2,0.5410544511668107,36.0,24.0
20182019,Mario Kempe,126,203,329,52,2,0.3829787234042553,181.0,141.0
20182019,Patrick Marleau,104,99,203,82,2,0.5123152709359606,72.0,147.0
20182019,Derek Ryan,440,316,756,81,2,0.582010582010582,2.0,61.0
20182019,Anthony Cirelli,502,449,951,82,2,0.5278654048370137,50.0,47.0
20182019,Artem Anisimov,332,394,726,78,2,0.4573002754820937,142.0,89.0
20182019,Mathew Barzal,241,339,580,82,2,0.41551724137931034,171.0,111.0
20182019,Ryan O'Reilly,1086,824,1910,82,2,0.5685863874345549,9.0,1.0
20182019,Sean Kuraly,286,245,531,71,2,0.5386064030131826,38.0,98.0
20182019,Joe Thornton,356,319,675,73,2,0.5274074074074074,51.0,83.0
20182019,Brett Howden,353,376,729,66,2,0.4842249657064472,115.0,84.0
20182019,Tomas Hertl,609,574,1183,77,2,0.514792899408284,67.0,25.0
20182019,Anze Kopitar,1002,817,1819,81,2,0.5508521165475536,24.0,6.0
20182019,Jeff Skinner,157,144,301,82,2,0.521594684385382,58.0,131.0
20182019,Tyler Seguin,676,579,1255,82,2,0.5386454183266932,37.0,18.0
20182019,Nico Hischier,437,529,966,69,2,0.4523809523809524,148.0,62.0
20182019,Henrik Borgstrom,165,240,405,50,2,0.4074074074074074,175.0,129.0
20182019,Pierre-Luc Dubois,455,592,1047,82,2,0.43457497612225404,160.0,56.0
20182019,Adam Henrique,571,512,1083,82,2,0.5272391505078485,52.0,34.0
20182019,Derek Grant,271,244,515,56,2,0.5262135922330097,53.0,104.0
20182019,Sean Monahan,454,434,888,78,2,0.5112612612612613,74.0,57.0
20182019,Oscar Lindberg,101,122,223,55,2,0.452914798206278,147.0,149.0
20182019,Alex Galchenyuk,188,223,411,72,2,0.45742092457420924,139.0,122.0
20182019,Adam Lowry,643,473,1116,78,2,0.5761648745519713,5.0,22.0
20182019,Adam Gaudette,150,221,371,56,2,0.40431266846361186,176.0,134.0
20182019,Jacob de la Rose,161,219,380,60,2,0.4236842105263158,167.0,130.0
20182019,Nick Schmaltz,104,177,281,40,2,0.3701067615658363,185.0,147.0
20182019,Carter Rowney,171,176,347,62,2,0.49279538904899134,99.0,126.0
20182019,Joe Pavelski,526,463,989,75,2,0.531850353892821,47.0,41.0
20182019,Claude Giroux,674,490,1164,82,2,0.5790378006872853,4.0,19.0
20182019,Ryan Johansen,782,679,1461,80,2,0.5352498288843258,45.0,14.0
20182019,Brett Seney,98,162,260,51,2,0.3769230769230769,183.0,150.0
20182019,Colby Cave,200,199,399,53,2,0.5012531328320802,88.0,121.0
20182019,Gabriel Landeskog,361,333,694,73,2,0.5201729106628242,61.0,80.0
20182019,David Kampf,276,333,609,63,2,0.45320197044334976,146.0,101.0
20182019,Juho Lammikko,142,190,332,40,2,0.42771084337349397,165.0,137.0
20182019,Jared McCann,275,320,595,78,2,0.46218487394957986,137.0,102.0
20182019,Paul Stastny,463,384,847,50,2,0.5466351829988194,27.0,55.0
20182019,Jordan Weal,333,266,599,63,2,0.5559265442404007,18.0,88.0
20182019,Christian Dvorak,125,101,226,20,2,0.5530973451327433,22.0,142.0
20182019,William Karlsson,588,646,1234,82,2,0.47649918962722854,124.0,28.0
20182019,Jonathan Toews,1059,821,1880,82,2,0.5632978723404255,12.0,3.0
20182019,Vincent Trocheck,498,463,961,55,2,0.518210197710718,65.0,48.0
20182019,Vladimir Sobotka,318,295,613,69,2,0.5187601957585645,64.0,93.0
20182019,Alex Kerfoot,274,215,489,78,2,0.5603271983640081,14.0,103.0
20182019,Michael Chaput,124,120,244,32,2,0.5081967213114754,81.0,143.0
20182019,Valtteri Filppula,398,413,811,72,2,0.4907521578298397,104.0,73.0
20182019,Travis Zajac,841,605,1446,80,2,0.5816044260027663,3.0,9.0
20182019,Lucas Wallmark,575,554,1129,81,2,0.5093002657218778,79.0,33.0
20182019,Max Domi,447,549,996,82,2,0.44879518072289154,151.0,60.0
20182019,David Krejci,530,565,1095,81,2,0.4840182648401826,116.0,39.0
20182019,Nathan MacKinnon,517,666,1183,82,2,0.4370245139475909,158.0,42.0
20182019,Sean Couturier,755,568,1323,80,2,0.5706727135298564,7.0,15.0
20182019,J.T. Compher,301,311,612,66,2,0.4918300653594771,101.0,96.0
20182019,Cedric Paquette,404,364,768,80,2,0.5260416666666666,55.0,70.0
20182019,Jack Roslovic,91,118,209,77,2,0.4354066985645933,159.0,155.0
20182019,Josh Bailey,140,132,272,82,2,0.5147058823529411,68.0,138.0
20182019,Par Lindholm,204,203,407,65,2,0.5012285012285013,89.0,119.0
20182019,Radek Faksa,570,562,1132,81,2,0.5035335689045937,86.0,35.0
20182019,Kyle Turris,281,272,553,55,2,0.5081374321880651,83.0,100.0
20182019,Matthew Peca,80,89,169,39,2,0.47337278106508873,130.0,160.0
20182019,Colin White,379,420,799,71,2,0.47434292866082606,129.0,77.0
20182019,Mikko Koivu,488,406,894,48,2,0.5458612975391499,28.0,50.0
20182019,Nicklas Backstrom,700,739,1439,80,2,0.4864489228630994,110.0,16.0
20182019,Alex Wennberg,342,364,706,75,2,0.48441926345609065,114.0,87.0
20182019,Brayden Point,435,421,856,79,2,0.508177570093458,82.0,63.0
20182019,Phillip Danault,882,706,1588,81,2,0.5554156171284634,19.0,7.0
20182019,Evan Rodrigues,304,351,655,74,2,0.46412213740458014,135.0,95.0
20182019,Blake Coleman,109,153,262,78,2,0.41603053435114506,170.0,145.0
20182019,Matt Cullen,320,320,640,71,2,0.5,90.0,92.0
20182019,Scott Laughton,344,291,635,82,2,0.5417322834645669,35.0,86.0
20182019,Nazem Kadri,403,327,730,73,2,0.552054794520548,23.0,71.0
20182019,Jamie Benn,205,213,418,78,2,0.4904306220095694,106.0,118.0
20182019,Carl Soderberg,528,542,1070,82,2,0.4934579439252336,97.0,40.0
20182019,Eric Staal,642,615,1257,81,2,0.5107398568019093,75.0,23.0
20182019,Frederik Gauthier,240,207,447,70,2,0.5369127516778524,42.0,112.0
20182019,Nolan Patrick,399,380,779,72,2,0.5121951219512195,73.0,72.0
20182019,Dylan Larkin,865,722,1587,76,2,0.5450535601764335,29.0,8.0
20182019,Nick Bonino,586,546,1132,81,2,0.5176678445229682,66.0,29.0
20182019,Riley Sheahan,360,328,688,82,2,0.5232558139534884,57.0,81.0
20182019,Mark Jankowski,426,394,820,79,2,0.5195121951219512,62.0,67.0
20182019,Dylan Strome,434,463,897,78,2,0.483835005574136,118.0,64.0
20182019,Lias Andersson,84,106,190,42,2,0.4421052631578947,154.0,158.0
20182019,Erik Haula,78,74,152,15,2,0.5131578947368421,70.0,161.0
20182019,Markus Granlund,149,199,348,77,2,0.4281609195402299,164.0,135.0
20182019,Ivan Barbashev,201,240,441,80,2,0.4557823129251701,145.0,120.0
20182019,Evgeny Kuznetsov,45,64,109,7,3,0.41284403669724773,67.0,33.0
20182019,Evander Kane,10,30,40,20,3,0.25,76.0,55.0
20182019,Roope Hintz,82,83,165,13,3,0.49696969696969695,40.0,17.0
20182019,Zach Hyman,10,21,31,7,3,0.3225806451612903,74.0,55.0
20182019,Nick Foligno,28,29,57,10,3,0.49122807017543857,45.0,43.0
20182019,Casey Cizikas,70,55,125,8,3,0.56,13.0,22.0
20182019,Patrice Bergeron,294,207,501,24,3,0.5868263473053892,8.0,2.0
20182019,Noel Acciari,55,56,111,19,3,0.4954954954954955,42.0,29.0
20182019,Barclay Goodrow,90,94,184,20,3,0.4891304347826087,46.0,14.0
20182019,Elias Lindholm,38,23,61,5,3,0.6229508196721312,3.0,37.0
20182019,Calle Jarnkrok,21,23,44,6,3,0.4772727272727273,52.0,48.0
20182019,Nick Bjugstad,16,25,41,4,3,0.3902439024390244,70.0,52.0
20182019,Steven Stamkos,19,22,41,4,3,0.4634146341463415,60.0,50.0
20182019,Tyler Bozak,161,137,298,26,3,0.540268456375839,19.0,5.0
20182019,Sidney Crosby,47,42,89,4,3,0.5280898876404494,21.0,32.0
20182019,Oskar Sundqvist,96,108,204,25,3,0.47058823529411764,55.0,13.0
20182019,Brandon Dubinsky,48,37,85,10,3,0.5647058823529412,11.0,31.0
20182019,Kevin Hayes,16,20,36,6,3,0.4444444444444444,63.0,52.0
20182019,Brock Nelson,58,75,133,8,3,0.43609022556390975,65.0,28.0
20182019,Lars Eller,43,46,89,7,3,0.48314606741573035,47.0,34.0
20182019,Justin Williams,17,28,45,15,3,0.37777777777777777,71.0,51.0
20182019,Jordan Staal,175,163,338,15,3,0.5177514792899408,27.0,4.0
20182019,Colton Sissons,32,35,67,6,3,0.47761194029850745,51.0,41.0
20182019,Matt Duchene,73,69,142,10,3,0.5140845070422535,28.0,20.0
20182019,Mikael Backlund,37,38,75,5,3,0.49333333333333335,43.0,38.0
20182019,Greg McKegg,47,45,92,14,3,0.5108695652173914,32.0,32.0
20182019,Pierre-Edouard Bellemare,32,31,63,6,3,0.5079365079365079,34.0,41.0
20182019,Mark Scheifele,52,69,121,6,3,0.4297520661157025,66.0,30.0
20182019,Logan Couture,112,128,240,20,3,0.4666666666666667,57.0,11.0
20182019,William Nylander,24,24,48,7,3,0.5,38.0,46.0
20182019,Auston Matthews,55,52,107,7,3,0.514018691588785,29.0,29.0
20182019,John Tavares,65,72,137,7,3,0.4744525547445255,54.0,23.0
20182019,Cody Eakin,55,51,106,7,3,0.5188679245283019,25.0,29.0
20182019,Bryan Little,41,40,81,6,3,0.5061728395061729,35.0,35.0
20182019,Sebastian Aho,64,73,137,15,3,0.46715328467153283,56.0,24.0
20182019,Brayden Schenn,150,152,302,26,3,0.4966887417218543,41.0,6.0
20182019,Jason Spezza,48,43,91,11,3,0.5274725274725275,22.0,31.0
20182019,Boone Jenner,71,73,144,10,3,0.4930555555555556,44.0,21.0
20182019,Patrick Marleau,23,14,37,7,3,0.6216216216216216,4.0,47.0
20182019,Derek Ryan,35,24,59,5,3,0.5932203389830508,6.0,39.0
20182019,William Karlsson,52,60,112,7,3,0.4642857142857143,59.0,30.0
20182019,Alex Kerfoot,14,16,30,12,3,0.4666666666666667,57.0,53.0
20182019,Matt Cullen,21,17,38,4,3,0.5526315789473685,14.0,48.0
20182019,Sean Monahan,48,27,75,5,3,0.64,2.0,31.0
20182019,Derick Brassard,25,18,43,9,3,0.5813953488372093,9.0,45.0
20182019,Ryan Johansen,77,63,140,6,3,0.55,15.0,19.0
20182019,Jamie Benn,45,43,88,13,3,0.5113636363636364,31.0,33.0
20182019,Carl Soderberg,61,87,148,12,3,0.41216216216216217,68.0,25.0
20182019,Frederik Gauthier,11,21,32,7,3,0.34375,73.0,54.0
20182019,Anthony Cirelli,24,21,45,4,3,0.5333333333333333,20.0,46.0
20182019,Mathew Barzal,29,28,57,8,3,0.5087719298245614,33.0,42.0
20182019,Ryan O'Reilly,308,307,615,26,3,0.5008130081300813,37.0,1.0
20182019,Sean Kuraly,115,113,228,20,3,0.5043859649122807,36.0,10.0
20182019,Joe Thornton,112,106,218,19,3,0.5137614678899083,30.0,11.0
20182019,Tomas Hertl,244,190,434,19,3,0.5622119815668203,12.0,3.0
20182019,Valtteri Filppula,43,28,71,8,3,0.6056338028169014,5.0,34.0
20182019,David Krejci,141,131,272,24,3,0.5183823529411765,26.0,7.0
20182019,J.T. Compher,59,72,131,12,3,0.45038167938931295,62.0,27.0
20182019,Lucas Wallmark,96,96,192,15,3,0.5,38.0,13.0
20182019,Nathan MacKinnon,81,103,184,12,3,0.44021739130434784,64.0,18.0
20182019,Ivan Barbashev,70,75,145,25,3,0.4827586206896552,48.0,22.0
20182019,Brad Marchand,9,25,34,24,3,0.2647058823529412,75.0,56.0
20182019,Evgeni Malkin,23,25,48,4,3,0.4791666666666667,49.0,47.0
20182019,Nic Dowd,35,26,61,7,3,0.5737704918032787,10.0,39.0
20182019,Justin Dowling,21,25,46,13,3,0.45652173913043476,61.0,48.0
20182019,J.T. Miller,20,14,34,4,3,0.5882352941176471,7.0,49.0
20182019,Paul Stastny,83,68,151,7,3,0.5496688741721855,16.0,16.0
20182019,Gabriel Landeskog,70,70,140,12,3,0.5,38.0,22.0
20182019,Radek Faksa,102,103,205,13,3,0.4975609756097561,39.0,12.0
20182019,Kyle Turris,26,26,52,6,3,0.5,38.0,44.0
20182019,Tyson Jost,21,35,56,12,3,0.375,72.0,48.0
20182019,Brayden Point,19,16,35,4,3,0.5428571428571428,18.0,50.0
20182019,Nicklas Backstrom,88,79,167,7,3,0.5269461077844312,23.0,15.0
20182019,Pierre-Luc Dubois,60,90,150,10,3,0.4,69.0,26.0
20182019,Tyler Seguin,127,115,242,13,3,0.5247933884297521,24.0,8.0
20182019,Adam Lowry,55,46,101,6,3,0.5445544554455446,17.0,29.0
20182019,Joe Pavelski,55,60,115,13,3,0.4782608695652174,50.0,29.0
20182019,Cedric Paquette,20,23,43,4,3,0.46511627906976744,58.0,49.0
20182019,Nick Bonino,40,28,68,6,3,0.5882352941176471,7.0,36.0
20182019,Charlie Coyle,122,135,257,24,3,0.47470817120622566,53.0,9.0
20182019,Mark Jankowski,34,19,53,5,3,0.6415094339622641,1.0,40.0
20192020,Tyler Johnson,173,180,353,65,2,0.49008498583569404,87.0,107.0
20192020,T.J. Oshie,119,119,238,69,2,0.5,71.0,120.0
20192020,Evgeny Kuznetsov,348,455,803,63,2,0.43337484433374845,140.0,65.0
20192020,Kevin Rooney,175,197,372,49,2,0.47043010752688175,109.0,106.0
20192020,Michael Raffl,99,98,197,58,2,0.5025380710659898,67.0,129.0
20192020,Nate Thompson,433,354,787,70,2,0.5501905972045743,20.0,34.0
20192020,Evander Kane,106,95,201,64,2,0.527363184079602,42.0,125.0
20192020,Johan Larsson,322,346,668,62,2,0.4820359281437126,94.0,71.0
20192020,Dylan Gambrell,170,200,370,50,2,0.4594594594594595,125.0,109.0
20192020,Roope Hintz,172,173,345,60,2,0.4985507246376812,73.0,108.0
20192020,Kevin Hayes,415,411,826,69,2,0.5024213075060533,68.0,38.0
20192020,Zach Hyman,70,90,160,51,2,0.4375,139.0,140.0
20192020,Carl Soderberg,245,296,541,70,2,0.45286506469500926,129.0,88.0
20192020,Nick Foligno,159,160,319,67,2,0.49843260188087773,75.0,111.0
20192020,Ryan Hartman,83,69,152,69,2,0.5460526315789473,24.0,137.0
20192020,Luke Kunin,210,262,472,63,2,0.4449152542372881,134.0,95.0
20192020,Casey Mittelstadt,86,99,185,31,2,0.4648648648648649,115.0,135.0
20192020,Casey Cizikas,368,320,688,48,2,0.5348837209302325,36.0,54.0
20192020,Joel Eriksson Ek,367,428,795,62,2,0.46163522012578617,120.0,55.0
20192020,Ryan Nugent-Hopkins,205,199,404,65,2,0.5074257425742574,63.0,97.0
20192020,Blake Lizotte,312,310,622,65,2,0.5016077170418006,69.0,75.0
20192020,Jesperi Kotkaniemi,125,167,292,36,2,0.4280821917808219,146.0,118.0
20192020,Derek Stepan,569,628,1197,70,2,0.4753550543024227,102.0,18.0
20192020,Jean-Gabriel Pageau,615,534,1149,67,2,0.5352480417754569,35.0,13.0
20192020,Patrice Bergeron,759,552,1311,61,2,0.5789473684210527,4.0,4.0
20192020,Mitchell Stephens,187,169,356,38,2,0.5252808988764045,44.0,104.0
20192020,Frans Nielsen,210,246,456,60,2,0.4605263157894737,122.0,95.0
20192020,Barclay Goodrow,393,406,799,70,2,0.4918648310387985,83.0,45.0
20192020,Elias Lindholm,395,406,801,70,2,0.49313358302122345,80.0,44.0
20192020,Greg McKegg,104,107,211,53,2,0.4928909952606635,81.0,127.0
20192020,Artem Anisimov,185,185,370,49,2,0.5,71.0,105.0
20192020,Sidney Crosby,494,394,888,41,2,0.5563063063063063,13.0,30.0
20192020,Steven Stamkos,365,307,672,57,2,0.5431547619047619,26.0,56.0
20192020,Pavel Zacha,283,371,654,65,2,0.4327217125382263,141.0,80.0
20192020,Tyler Bozak,363,297,660,67,2,0.55,21.0,57.0
20192020,Joel Kellman,112,126,238,31,2,0.47058823529411764,108.0,124.0
20192020,Colton Sissons,283,269,552,57,2,0.5126811594202898,57.0,80.0
20192020,Mikael Backlund,368,410,778,70,2,0.4730077120822622,107.0,54.0
20192020,Kirby Dach,75,147,222,64,2,0.33783783783783783,154.0,138.0
20192020,Nicolas Roy,93,100,193,28,2,0.48186528497409326,95.0,131.0
20192020,Luke Glendening,393,307,700,60,2,0.5614285714285714,10.0,45.0
20192020,Lucas Wallmark,379,374,753,67,2,0.5033200531208499,65.0,51.0
20192020,Joe Pavelski,351,301,652,67,2,0.5383435582822086,33.0,62.0
20192020,Sebastian Aho,409,480,889,68,2,0.46006749156355453,123.0,39.0
20192020,Chandler Stephenson,233,281,514,65,2,0.45330739299610895,128.0,90.0
20192020,Brayden Schenn,350,364,714,71,2,0.49019607843137253,86.0,63.0
20192020,Brady Tkachuk,144,168,312,71,2,0.46153846153846156,121.0,114.0
20192020,Derick Brassard,197,160,357,66,2,0.5518207282913166,16.0,99.0
20192020,Adrian Kempe,92,131,223,69,2,0.4125560538116592,150.0,132.0
20192020,Pierre-Edouard Bellemare,419,371,790,69,2,0.5303797468354431,39.0,37.0
20192020,Riley Nash,245,267,512,64,2,0.478515625,98.0,88.0
20192020,Blake Wheeler,325,327,652,71,2,0.49846625766871167,74.0,68.0
20192020,Oskar Sundqvist,105,132,237,57,2,0.4430379746835443,135.0,126.0
20192020,Jason Dickinson,196,251,447,65,2,0.43847874720357943,138.0,100.0
20192020,Sam Lafferty,117,119,236,50,2,0.4957627118644068,77.0,122.0
20192020,Brandon Sutter,185,193,378,44,2,0.4894179894179894,88.0,105.0
20192020,Nicholas Paul,191,182,373,56,2,0.5120643431635389,60.0,102.0
20192020,Logan Couture,195,248,443,52,2,0.4401805869074492,137.0,101.0
20192020,Jack Eichel,614,697,1311,68,2,0.4683447749809306,112.0,14.0
20192020,Valtteri Filppula,324,398,722,70,2,0.4487534626038781,131.0,69.0
20192020,Ryan Carpenter,263,347,610,69,2,0.4311475409836066,142.0,84.0
20192020,Andrew Copp,310,275,585,63,2,0.5299145299145299,40.0,77.0
20192020,William Nylander,106,106,212,68,2,0.5,71.0,125.0
20192020,Robert Thomas,136,181,317,66,2,0.42902208201892744,145.0,115.0
20192020,Boone Jenner,643,523,1166,70,2,0.5514579759862779,17.0,10.0
20192020,Vincent Trocheck,434,398,832,62,2,0.5216346153846154,49.0,33.0
20192020,Derek Ryan,383,349,732,68,2,0.523224043715847,48.0,48.0
20192020,Zack Smith,88,102,190,50,2,0.4631578947368421,117.0,134.0
20192020,Anthony Cirelli,434,480,914,68,2,0.474835886214442,105.0,33.0
20192020,Mathew Barzal,228,320,548,68,2,0.41605839416058393,149.0,92.0
20192020,Jared McCann,265,306,571,66,2,0.46409807355516636,116.0,83.0
20192020,Sam Steel,369,365,734,65,2,0.502724795640327,66.0,53.0
20192020,Mika Zibanejad,592,612,1204,57,2,0.49169435215946844,84.0,16.0
20192020,Michael Amadio,232,248,480,68,2,0.48333333333333334,93.0,91.0
20192020,Connor McDavid,320,350,670,64,2,0.47761194029850745,99.0,72.0
20192020,Ryan Strome,496,548,1044,70,2,0.47509578544061304,103.0,28.0
20192020,Jeff Carter,382,364,746,60,2,0.5120643431635389,60.0,49.0
20192020,Alex Kerfoot,191,216,407,65,2,0.4692874692874693,111.0,102.0
20192020,Auston Matthews,506,414,920,70,2,0.55,21.0,27.0
20192020,John Tavares,617,499,1116,63,2,0.5528673835125448,14.0,12.0
20192020,Bo Horvat,850,633,1483,69,2,0.5731625084288604,5.0,3.0
20192020,Mikael Granlund,73,77,150,63,2,0.4866666666666667,91.0,139.0
20192020,Filip Chytil,198,317,515,60,2,0.3844660194174757,153.0,98.0
20192020,Par Lindholm,132,156,288,40,2,0.4583333333333333,126.0,116.0
20192020,Curtis Lazar,185,176,361,38,2,0.5124653739612188,59.0,105.0
20192020,Brock Nelson,615,573,1188,68,2,0.5176767676767676,53.0,13.0
20192020,Aleksander Barkov,653,550,1203,66,2,0.542809642560266,27.0,9.0
20192020,Lars Eller,536,497,1033,69,2,0.5188770571151985,52.0,21.0
20192020,Derek Grant,358,336,694,56,2,0.515850144092219,56.0,60.0
20192020,Ryan Getzlaf,530,504,1034,69,2,0.5125725338491296,58.0,22.0
20192020,Mark Scheifele,605,684,1289,71,2,0.46935608999224204,110.0,15.0
20192020,Leon Draisaitl,661,608,1269,71,2,0.5208825847123719,50.0,8.0
20192020,Yanni Gourde,93,79,172,70,2,0.5406976744186046,29.0,131.0
20192020,Nikolai Prokhorkin,101,111,212,43,2,0.47641509433962265,101.0,128.0
20192020,Sam Bennett,89,83,172,52,2,0.5174418604651163,54.0,133.0
20192020,Brad Richardson,355,303,658,59,2,0.5395136778115501,31.0,61.0
20192020,Ryan O'Reilly,880,676,1556,71,2,0.5655526992287918,8.0,1.0
20192020,Sean Kuraly,254,267,521,69,2,0.4875239923224568,90.0,85.0
20192020,Joe Thornton,323,331,654,70,2,0.4938837920489297,79.0,70.0
20192020,Brett Howden,251,270,521,70,2,0.4817658349328215,96.0,86.0
20192020,Nico Hischier,507,473,980,58,2,0.5173469387755102,55.0,26.0
20192020,Dominic Toninato,128,144,272,46,2,0.47058823529411764,108.0,117.0
20192020,Brock Nelson,615,573,1188,68,2,0.5176767676767676,53.0,13.0
20192020,Aleksander Barkov,653,550,1203,66,2,0.542809642560266,27.0,9.0
20192020,Lars Eller,536,497,1033,69,2,0.5188770571151985,52.0,21.0
20192020,Logan Couture,195,248,443,52,2,0.4401805869074492,137.0,101.0
20192020,Jack Eichel,614,697,1311,68,2,0.4683447749809306,112.0,14.0
20192020,Valtteri Filppula,324,398,722,70,2,0.4487534626038781,131.0,69.0
20192020,Ryan Carpenter,263,347,610,69,2,0.4311475409836066,142.0,84.0
20192020,Andrew Copp,310,275,585,63,2,0.5299145299145299,40.0,77.0
20192020,William Nylander,106,106,212,68,2,0.5,71.0,125.0
20192020,Mikael Granlund,73,77,150,63,2,0.4866666666666667,91.0,139.0
20192020,Filip Chytil,198,317,515,60,2,0.3844660194174757,153.0,98.0
20192020,Par Lindholm,132,156,288,40,2,0.4583333333333333,126.0,116.0
20192020,Curtis Lazar,185,176,361,38,2,0.5124653739612188,59.0,105.0
20192020,Pierre-Luc Dubois,359,446,805,70,2,0.44596273291925465,133.0,59.0
20192020,Adam Henrique,512,418,930,71,2,0.5505376344086022,19.0,25.0
20192020,Jason Spezza,215,183,398,58,2,0.5402010050251256,30.0,94.0
20192020,Sean Monahan,549,495,1044,70,2,0.5258620689655172,43.0,19.0
20192020,Chris Wagner,115,134,249,67,2,0.46184738955823296,119.0,123.0
20192020,Adam Lowry,349,300,649,49,2,0.5377503852080123,34.0,64.0
20192020,Adam Gaudette,187,267,454,59,2,0.4118942731277533,151.0,104.0
20192020,Claude Giroux,663,460,1123,69,2,0.5903829029385574,3.0,7.0
20192020,Erik Haula,381,323,704,48,2,0.5411931818181818,28.0,50.0
20192020,Ryan Johansen,549,483,1032,68,2,0.5319767441860465,37.0,19.0
20192020,Jordan Weal,96,97,193,49,2,0.49740932642487046,76.0,130.0
20192020,Gabriel Landeskog,274,212,486,54,2,0.5637860082304527,9.0,82.0
20192020,David Kampf,313,285,598,70,2,0.5234113712374582,47.0,74.0
20192020,Paul Stastny,624,515,1139,71,2,0.5478489903424056,22.0,11.0
20192020,Jacob de la Rose,118,156,274,50,2,0.4306569343065693,144.0,121.0
20192020,Christian Dvorak,523,426,949,70,2,0.5511064278187566,18.0,23.0
20192020,Nazem Kadri,407,310,717,51,2,0.5676429567642957,7.0,40.0
20192020,William Karlsson,491,455,946,63,2,0.5190274841437632,51.0,31.0
20192020,Gaetan Haas,172,236,408,58,2,0.4215686274509804,148.0,108.0
20192020,Jonathan Toews,856,638,1494,70,2,0.5729585006693441,6.0,2.0
20192020,Cody Eakin,311,330,641,49,2,0.48517940717628705,92.0,76.0
20192020,Matt Duchene,390,305,695,66,2,0.5611510791366906,11.0,46.0
20192020,Travis Zajac,576,514,1090,69,2,0.5284403669724771,41.0,17.0
20192020,Max Domi,385,403,788,71,2,0.4885786802030457,89.0,47.0
20192020,David Krejci,371,366,737,61,2,0.5033921302578019,64.0,52.0
20192020,Nathan MacKinnon,362,478,840,69,2,0.430952380952381,143.0,58.0
20192020,Sean Couturier,542,367,909,69,2,0.5962596259625963,1.0,20.0
20192020,J.T. Compher,341,374,715,67,2,0.47692307692307695,100.0,66.0
20192020,Cedric Paquette,316,305,621,61,2,0.5088566827697263,62.0,73.0
20192020,Josh Bailey,128,128,256,68,2,0.5,71.0,117.0
20192020,Brian Boyle,197,179,376,39,2,0.523936170212766,46.0,99.0
20192020,Radek Faksa,404,406,810,66,2,0.49876543209876545,72.0,41.0
20192020,Kyle Turris,246,272,518,62,2,0.4749034749034749,104.0,87.0
20192020,Denis Malgin,65,98,163,44,2,0.3987730061349693,152.0,141.0
20192020,Tyson Jost,85,170,255,67,2,0.3333333333333333,155.0,136.0
20192020,Teddy Blueger,402,488,890,69,2,0.451685393258427,130.0,42.0
20192020,Colin White,275,305,580,61,2,0.47413793103448276,106.0,81.0
20192020,Riley Sheahan,409,425,834,66,2,0.4904076738609113,85.0,39.0
20192020,Mikko Koivu,431,380,811,55,2,0.531442663378545,38.0,35.0
20192020,Nicklas Backstrom,516,532,1048,61,2,0.49236641221374045,82.0,24.0
20192020,Alex Wennberg,309,363,672,57,2,0.45982142857142855,124.0,78.0
20192020,Brayden Point,397,380,777,66,2,0.510939510939511,61.0,43.0
20192020,Phillip Danault,728,608,1336,71,2,0.5449101796407185,25.0,5.0
20192020,Victor Rask,120,152,272,43,2,0.4411764705882353,136.0,119.0
20192020,Nicholas Shore,210,170,380,63,2,0.5526315789473685,15.0,95.0
20192020,J.T. Miller,425,293,718,69,2,0.5919220055710307,2.0,36.0
20192020,Scott Laughton,146,125,271,49,2,0.5387453874538746,32.0,113.0
20192020,Jamie Benn,244,193,437,69,2,0.5583524027459954,12.0,89.0
20192020,Eric Staal,495,504,999,66,2,0.4954954954954955,78.0,29.0
20192020,Noel Acciari,381,413,794,66,2,0.47984886649874053,97.0,50.0
20192020,Frederik Gauthier,208,172,380,61,2,0.5473684210526316,23.0,96.0
20192020,Dylan Larkin,714,648,1362,71,2,0.5242290748898678,45.0,6.0
20192020,Nick Bonino,488,440,928,67,2,0.5258620689655172,43.0,32.0
20192020,Charlie Coyle,326,373,699,70,2,0.4663805436337625,114.0,67.0
20192020,Evan Rodrigues,120,137,257,45,2,0.4669260700389105,113.0,119.0
20192020,Mark Jankowski,190,235,425,56,2,0.4470588235294118,132.0,103.0
20192020,Tomas Nosek,217,216,433,67,2,0.5011547344110855,70.0,93.0
20192020,Nick Suzuki,305,354,659,71,2,0.4628224582701062,118.0,79.0
20192020,Nick Schmaltz,160,216,376,70,2,0.425531914893617,147.0,110.0
20192020,Ivan Barbashev,149,179,328,69,2,0.45426829268292684,127.0,112.0
20192020,Tyler Johnson,83,104,187,25,3,0.44385026737967914,74.0,23.0
20192020,T.J. Oshie,19,21,40,8,3,0.475,62.0,60.0
20192020,Evgeny Kuznetsov,52,90,142,8,3,0.36619718309859156,91.0,36.0
20192020,Milan Lucic,30,26,56,10,3,0.5357142857142857,27.0,50.0
20192020,Travis Boyd,12,29,41,4,3,0.2926829268292683,95.0,65.0
20192020,Roope Hintz,79,74,153,25,3,0.5163398692810458,38.0,27.0
20192020,Carl Soderberg,47,50,97,9,3,0.4845360824742268,57.0,40.0
20192020,Kevin Hayes,83,84,167,16,3,0.49700598802395207,52.0,23.0
20192020,Jesperi Kotkaniemi,25,49,74,10,3,0.33783783783783783,92.0,55.0
20192020,Casey Cizikas,80,108,188,18,3,0.425531914893617,82.0,26.0
20192020,Joel Eriksson Ek,20,28,48,4,3,0.4166666666666667,84.0,59.0
20192020,Derek Stepan,81,102,183,9,3,0.4426229508196721,75.0,25.0
20192020,Patrice Bergeron,180,141,321,13,3,0.5607476635514018,15.0,5.0
20192020,Mitchell Stephens,31,33,64,7,3,0.484375,58.0,49.0
20192020,Elias Lindholm,32,31,63,10,3,0.5079365079365079,45.0,48.0
20192020,Chandler Stephenson,77,103,180,20,3,0.42777777777777776,81.0,29.0
20192020,Tyler Bozak,52,64,116,8,3,0.4482758620689655,71.0,36.0
20192020,Sidney Crosby,53,52,105,4,3,0.5047619047619047,49.0,35.0
20192020,Erik Haula,16,16,32,4,3,0.5,51.0,62.0
20192020,Blake Wheeler,22,14,36,4,3,0.6111111111111112,3.0,57.0
20192020,Oskar Sundqvist,18,27,45,9,3,0.4,86.0,61.0
20192020,Jason Dickinson,77,119,196,27,3,0.39285714285714285,88.0,29.0
20192020,Mika Zibanejad,32,29,61,3,3,0.5245901639344263,33.0,48.0
20192020,Connor McDavid,25,33,58,4,3,0.43103448275862066,79.0,55.0
20192020,Ryan Strome,21,24,45,3,3,0.4666666666666667,65.0,58.0
20192020,Brock Nelson,181,162,343,22,3,0.5276967930029155,32.0,4.0
20192020,Aleksander Barkov,41,34,75,4,3,0.5466666666666666,24.0,42.0
20192020,Jordan Staal,85,73,158,8,3,0.5379746835443038,25.0,22.0
20192020,Alex Galchenyuk,25,24,49,4,3,0.5102040816326531,42.0,55.0
20192020,Lars Eller,38,36,74,5,3,0.5135135135135135,41.0,45.0
20192020,Colton Sissons,29,23,52,4,3,0.5576923076923077,16.0,51.0
20192020,Mikael Backlund,73,93,166,10,3,0.4397590361445783,76.0,30.0
20192020,Cody Eakin,26,26,52,4,3,0.5,51.0,54.0
20192020,Brandon Sutter,80,71,151,17,3,0.5298013245033113,31.0,26.0
20192020,Kirby Dach,25,56,81,9,3,0.30864197530864196,94.0,55.0
20192020,Nicolas Roy,95,109,204,20,3,0.46568627450980393,66.0,17.0
20192020,Sam Bennett,25,35,60,10,3,0.4166666666666667,84.0,55.0
20192020,Brad Richardson,48,47,95,9,3,0.5052631578947369,48.0,39.0
20192020,Filip Chytil,14,22,36,3,3,0.3888888888888889,89.0,64.0
20192020,Par Lindholm,28,29,57,6,3,0.49122807017543857,56.0,52.0
20192020,Adam Lowry,36,33,69,4,3,0.5217391304347826,35.0,47.0
20192020,Adam Gaudette,21,24,45,10,3,0.4666666666666667,65.0,58.0
20192020,Max Domi,29,28,57,10,3,0.5087719298245614,44.0,51.0
20192020,David Krejci,78,75,153,13,3,0.5098039215686274,43.0,28.0
20192020,Nathan MacKinnon,93,101,194,15,3,0.4793814432989691,60.0,18.0
20192020,Jean-Gabriel Pageau,208,166,374,22,3,0.5561497326203209,17.0,2.0
20192020,J.T. Compher,78,79,157,15,3,0.4968152866242038,53.0,28.0
20192020,Sean Couturier,119,90,209,15,3,0.569377990430622,11.0,13.0
20192020,Vincent Trocheck,51,52,103,8,3,0.49514563106796117,54.0,37.0
20192020,Nate Thompson,101,67,168,16,3,0.6011904761904762,4.0,15.0
20192020,Nick Cousins,11,19,30,17,3,0.36666666666666664,90.0,66.0
20192020,Jay Beagle,124,93,217,17,3,0.5714285714285714,10.0,12.0
20192020,Sebastian Aho,54,67,121,8,3,0.4462809917355372,72.0,34.0
20192020,Brayden Schenn,36,45,81,9,3,0.4444444444444444,73.0,47.0
20192020,Robert Thomas,29,24,53,8,3,0.5471698113207547,22.0,51.0
20192020,Boone Jenner,93,88,181,10,3,0.5138121546961326,40.0,18.0
20192020,Derek Ryan,30,39,69,10,3,0.43478260869565216,77.0,50.0
20192020,Sean Monahan,96,71,167,10,3,0.5748502994011976,9.0,16.0
20192020,Chris Wagner,18,17,35,12,3,0.5142857142857142,39.0,61.0
20192020,Morgan Geekie,27,32,59,8,3,0.4576271186440678,69.0,53.0
20192020,Cedric Paquette,85,74,159,25,3,0.5345911949685535,28.0,22.0
20192020,Brian Boyle,22,17,39,4,3,0.5641025641025641,12.0,57.0
20192020,Nick Bonino,32,23,55,4,3,0.5818181818181818,6.0,48.0
20192020,Charlie Coyle,82,72,154,13,3,0.5324675324675324,29.0,24.0
20192020,Derek Grant,42,46,88,15,3,0.4772727272727273,61.0,41.0
20192020,Nick Suzuki,72,107,179,10,3,0.4022346368715084,85.0,31.0
20192020,Tomas Nosek,26,30,56,8,3,0.4642857142857143,67.0,54.0
20192020,Yanni Gourde,127,166,293,25,3,0.4334470989761092,78.0,10.0
20192020,Andrew Copp,26,24,50,4,3,0.52,36.0,54.0
20192020,Leon Draisaitl,51,44,95,4,3,0.5368421052631579,26.0,37.0
20192020,Anthony Cirelli,126,149,275,25,3,0.4581818181818182,68.0,11.0
20192020,Mathew Barzal,92,104,196,22,3,0.46938775510204084,63.0,19.0
20192020,Ryan O'Reilly,133,79,212,9,3,0.6273584905660378,2.0,8.0
20192020,Sean Kuraly,42,39,81,10,3,0.5185185185185185,37.0,41.0
20192020,Gabriel Landeskog,54,49,103,14,3,0.5242718446601942,34.0,34.0
20192020,David Kampf,49,36,85,9,3,0.5764705882352941,7.0,38.0
20192020,Paul Stastny,131,127,258,18,3,0.5077519379844961,46.0,9.0
20192020,Christian Dvorak,57,77,134,9,3,0.4253731343283582,83.0,33.0
20192020,J.T. Miller,86,69,155,17,3,0.5548387096774193,18.0,21.0
20192020,Scott Laughton,23,26,49,15,3,0.46938775510204084,63.0,56.0
20192020,Alex Kerfoot,15,31,46,5,3,0.32608695652173914,93.0,63.0
20192020,Auston Matthews,40,40,80,5,3,0.5,51.0,43.0
20192020,John Tavares,57,42,99,5,3,0.5757575757575758,8.0,33.0
20192020,Joe Pavelski,206,160,366,27,3,0.5628415300546448,14.0,3.0
20192020,Evgeni Malkin,26,21,47,4,3,0.5531914893617021,19.0,54.0
20192020,Elias Pettersson,39,40,79,17,3,0.4936708860759494,55.0,44.0
20192020,Nic Dowd,40,31,71,8,3,0.5633802816901409,13.0,43.0
20192020,Derick Brassard,37,36,73,18,3,0.5068493150684932,47.0,46.0
20192020,Pierre-Edouard Bellemare,90,89,179,15,3,0.5027932960893855,50.0,20.0
20192020,Riley Nash,71,58,129,10,3,0.5503875968992248,20.0,32.0
20192020,Nazem Kadri,124,109,233,15,3,0.5321888412017167,30.0,12.0
20192020,William Karlsson,135,180,315,20,3,0.42857142857142855,80.0,7.0
20192020,Jonathan Toews,117,96,213,9,3,0.5492957746478874,21.0,14.0
20192020,Barclay Goodrow,93,112,205,25,3,0.45365853658536587,70.0,18.0
20192020,Jamie Benn,140,116,256,27,3,0.546875,23.0,6.0
20192020,Eric Staal,31,47,78,4,3,0.3974358974358974,87.0,49.0
20192020,Noel Acciari,36,19,55,4,3,0.6545454545454545,1.0,47.0
20192020,Anders Lee,38,43,81,22,3,0.4691358024691358,64.0,45.0
20192020,Dylan Strome,57,54,111,9,3,0.5135135135135135,41.0,33.0
20192020,Bo Horvat,246,171,417,17,3,0.5899280575539568,5.0,1.0
20192020,Jonathan Marchessault,15,16,31,20,3,0.4838709677419355,59.0,63.0
20192020,Evgeni Malkin,26,21,47,4,3,0.5531914893617021,19.0,54.0
20192020,Elias Pettersson,39,40,79,17,3,0.4936708860759494,55.0,44.0
20192020,Nic Dowd,40,31,71,8,3,0.5633802816901409,13.0,43.0
20192020,Derick Brassard,37,36,73,18,3,0.5068493150684932,47.0,46.0
20192020,Pierre-Edouard Bellemare,90,89,179,15,3,0.5027932960893855,50.0,20.0
20192020,Riley Nash,71,58,129,10,3,0.5503875968992248,20.0,32.0
20192020,Nazem Kadri,124,109,233,15,3,0.5321888412017167,30.0,12.0
20192020,William Karlsson,135,180,315,20,3,0.42857142857142855,80.0,7.0
20192020,Jonathan Toews,117,96,213,9,3,0.5492957746478874,21.0,14.0
20192020,Barclay Goodrow,93,112,205,25,3,0.45365853658536587,70.0,18.0
20192020,Jamie Benn,140,116,256,27,3,0.546875,23.0,6.0
20192020,Eric Staal,31,47,78,4,3,0.3974358974358974,87.0,49.0
20192020,Noel Acciari,36,19,55,4,3,0.6545454545454545,1.0,47.0
20202021,Tyler Johnson,170,140,310,55,2,0.5483870967741935,29.0,98.0
20202021,T.J. Oshie,139,151,290,53,2,0.4793103448275862,106.0,109.0
20202021,Evgeny Kuznetsov,204,289,493,41,2,0.41379310344827586,159.0,85.0
20202021,Jeff Carter,153,161,314,54,2,0.4872611464968153,95.0,103.0
20202021,Dylan Gambrell,279,358,637,49,2,0.4379905808477237,143.0,55.0
20202021,Jaret Anderson-Dolan,132,170,302,34,2,0.4370860927152318,144.0,113.0
20202021,Michael Amadio,94,94,188,25,2,0.5,78.0,131.0
20202021,Roope Hintz,231,238,469,41,2,0.4925373134328358,87.0,75.0
20202021,Kevin Hayes,234,244,478,55,2,0.4895397489539749,94.0,73.0
20202021,Ryan Hartman,198,279,477,51,2,0.41509433962264153,158.0,89.0
20202021,Jesperi Kotkaniemi,263,286,549,56,2,0.4790528233151184,107.0,64.0
20202021,Casey Mittelstadt,216,225,441,41,2,0.4897959183673469,92.0,83.0
20202021,Casey Cizikas,340,299,639,56,2,0.5320813771517997,38.0,39.0
20202021,Nick Bjugstad,125,145,270,44,2,0.46296296296296297,124.0,117.0
20202021,Joel Eriksson Ek,395,444,839,56,2,0.47079856972586415,115.0,26.0
20202021,Ryan Nugent-Hopkins,73,87,160,52,2,0.45625,131.0,140.0
20202021,Blake Lizotte,180,174,354,41,2,0.5084745762711864,71.0,95.0
20202021,Cody Glass,110,149,259,27,2,0.4247104247104247,155.0,124.0
20202021,Dylan Cozens,96,106,202,41,2,0.4752475247524752,110.0,130.0
20202021,David Backes,81,79,160,15,2,0.50625,72.0,135.0
20202021,Carl Soderberg,201,190,391,45,2,0.5140664961636828,66.0,87.0
20202021,Patrice Bergeron,714,433,1147,54,2,0.6224934612031386,1.0,1.0
20202021,Pius Suter,266,359,625,55,2,0.4256,154.0,63.0
20202021,Jake Evans,203,202,405,47,2,0.5012345679012346,77.0,86.0
20202021,Elias Lindholm,509,482,991,56,2,0.513622603430878,67.0,12.0
20202021,Pierre Engvall,102,135,237,42,2,0.43037974683544306,150.0,127.0
20202021,Sidney Crosby,676,586,1262,55,2,0.5356576862123613,37.0,3.0
20202021,Steven Stamkos,238,178,416,38,2,0.5721153846153846,9.0,71.0
20202021,Pavel Zacha,312,294,606,50,2,0.5148514851485149,64.0,47.0
20202021,Chandler Stephenson,375,369,744,51,2,0.5040322580645161,74.0,31.0
20202021,Tyler Bozak,217,165,382,31,2,0.5680628272251309,12.0,82.0
20202021,Oskar Sundqvist,115,124,239,28,2,0.4811715481171548,104.0,122.0
20202021,Jason Dickinson,137,159,296,51,2,0.46283783783783783,125.0,110.0
20202021,Sam Steel,237,212,449,42,2,0.5278396436525612,43.0,72.0
20202021,Mika Zibanejad,479,555,1034,56,2,0.4632495164410058,123.0,15.0
20202021,Connor McDavid,316,322,638,56,2,0.4952978056426332,82.0,46.0
20202021,Ryan Strome,321,422,743,56,2,0.43203230148048455,149.0,43.0
20202021,Riley Sheahan,256,247,503,53,2,0.5089463220675944,70.0,67.0
20202021,Vincent Trocheck,431,338,769,47,2,0.5604681404421327,19.0,22.0
20202021,Sam Bennett,124,137,261,48,2,0.47509578544061304,111.0,118.0
20202021,Jay Beagle,173,135,308,30,2,0.5616883116883117,17.0,96.0
20202021,Dylan Strome,198,223,421,40,2,0.47030878859857483,116.0,89.0
20202021,Mikael Granlund,243,226,469,51,2,0.5181236673773987,59.0,69.0
20202021,Filip Chytil,130,174,304,42,2,0.4276315789473684,152.0,114.0
20202021,Ryan O'Reilly,703,493,1196,56,2,0.5877926421404682,5.0,2.0
20202021,Sean Kuraly,229,170,399,47,2,0.5739348370927319,7.0,77.0
20202021,Brett Howden,118,135,253,42,2,0.466403162055336,122.0,120.0
20202021,Tomas Hertl,486,394,880,50,2,0.5522727272727272,25.0,13.0
20202021,Anze Kopitar,661,493,1154,56,2,0.5727902946273831,8.0,4.0
20202021,Jujhar Khaira,171,207,378,40,2,0.4523809523809524,135.0,97.0
20202021,Josh Norris,379,345,724,56,2,0.5234806629834254,51.0,30.0
20202021,Brock Nelson,349,358,707,56,2,0.49363507779349364,85.0,38.0
20202021,Derek Stepan,130,130,260,20,2,0.5,78.0,114.0
20202021,Jordan Martinook,78,88,166,44,2,0.46987951807228917,118.0,136.0
20202021,Aleksander Barkov,563,463,1026,50,2,0.5487329434697856,28.0,8.0
20202021,Lars Eller,332,327,659,44,2,0.503793626707132,75.0,40.0
20202021,Logan Couture,444,456,900,53,2,0.49333333333333335,86.0,20.0
20202021,Jack Eichel,195,197,392,21,2,0.49744897959183676,80.0,91.0
20202021,Valtteri Filppula,109,133,242,38,2,0.45041322314049587,136.0,125.0
20202021,Andrew Copp,123,109,232,55,2,0.5301724137931034,40.0,119.0
20202021,Robert Thomas,112,151,263,33,2,0.42585551330798477,153.0,123.0
20202021,Boone Jenner,301,245,546,41,2,0.5512820512820513,26.0,50.0
20202021,Derek Ryan,153,141,294,43,2,0.5204081632653061,55.0,103.0
20202021,Nico Hischier,203,158,361,21,2,0.5623268698060941,16.0,86.0
20202021,Eetu Luostarinen,191,207,398,44,2,0.4798994974874372,105.0,93.0
20202021,Jack Hughes,216,395,611,56,2,0.353518821603928,167.0,83.0
20202021,Jordan Staal,628,455,1083,53,2,0.579870729455217,6.0,6.0
20202021,Chris Tierney,269,321,590,55,2,0.4559322033898305,132.0,61.0
20202021,Kirby Dach,77,114,191,18,2,0.4031413612565445,163.0,137.0
20202021,Alex Wennberg,388,400,788,56,2,0.49238578680203043,88.0,28.0
20202021,Nicolas Roy,142,175,317,50,2,0.4479495268138801,140.0,107.0
20202021,Luke Glendening,523,336,859,54,2,0.6088474970896391,2.0,10.0
20202021,Michael Rasmussen,134,168,302,40,2,0.44370860927152317,141.0,112.0
20202021,Joe Pavelski,362,334,696,56,2,0.5201149425287356,56.0,33.0
20202021,Derek Grant,289,277,566,46,2,0.5106007067137809,69.0,53.0
20202021,Philipp Kurashev,102,146,248,54,2,0.4112903225806452,161.0,127.0
20202021,Evgeni Malkin,152,206,358,33,2,0.4245810055865922,156.0,104.0
20202021,Nic Dowd,432,336,768,56,2,0.5625,15.0,21.0
20202021,Nick Foligno,117,144,261,49,2,0.4482758620689655,139.0,121.0
20202021,Brandon Sutter,276,221,497,43,2,0.5553319919517102,22.0,56.0
20202021,Nicholas Paul,219,201,420,56,2,0.5214285714285715,53.0,80.0
20202021,Ryan Getzlaf,350,326,676,48,2,0.5177514792899408,60.0,37.0
20202021,Mark Scheifele,352,355,707,56,2,0.49787835926449786,79.0,36.0
20202021,Leon Draisaitl,574,457,1031,56,2,0.5567410281280311,21.0,7.0
20202021,Yanni Gourde,316,333,649,56,2,0.4869029275808937,96.0,46.0
20202021,Bo Horvat,648,577,1225,56,2,0.5289795918367347,41.0,5.0
20202021,Derick Brassard,229,206,435,53,2,0.5264367816091954,47.0,77.0
20202021,Pierre-Edouard Bellemare,260,168,428,53,2,0.6074766355140186,3.0,65.0
20202021,Riley Nash,162,164,326,37,2,0.49693251533742333,81.0,100.0
20202021,Adam Henrique,303,244,547,45,2,0.5539305301645339,23.0,49.0
20202021,Jason Spezza,275,208,483,54,2,0.5693581780538303,10.0,57.0
20202021,Sean Monahan,340,354,694,50,2,0.4899135446685879,91.0,39.0
20202021,Travis Boyd,75,85,160,39,2,0.46875,119.0,138.0
20202021,Jack Roslovic,232,361,593,48,2,0.3912310286677909,165.0,74.0
20202021,Frederick Gaudreau,87,75,162,19,2,0.5370370370370371,36.0,132.0
20202021,Steven Lorentz,158,151,309,45,2,0.511326860841424,68.0,102.0
20202021,Colton Sissons,319,272,591,54,2,0.5397631133671743,34.0,44.0
20202021,Mikael Backlund,387,358,745,54,2,0.5194630872483221,57.0,29.0
20202021,Sam Reinhart,126,150,276,54,2,0.45652173913043476,130.0,116.0
20202021,Alex Kerfoot,124,180,304,56,2,0.40789473684210525,162.0,118.0
20202021,Auston Matthews,450,417,867,52,2,0.5190311418685121,58.0,19.0
20202021,John Tavares,471,381,852,56,2,0.5528169014084507,24.0,18.0
20202021,Pierre-Luc Dubois,166,216,382,46,2,0.43455497382198954,146.0,99.0
20202021,Sebastian Aho,365,327,692,56,2,0.5274566473988439,46.0,32.0
20202021,Brayden Schenn,318,290,608,56,2,0.5230263157894737,52.0,45.0
20202021,Brady Tkachuk,118,131,249,56,2,0.4738955823293173,113.0,120.0
20202021,Johan Larsson,296,313,609,52,2,0.4860426929392447,98.0,51.0
20202021,Gabriel Vilardi,291,343,634,54,2,0.4589905362776025,128.0,52.0
20202021,Vladislav Namestnikov,135,210,345,53,2,0.391304347826087,164.0,111.0
20202021,Anthony Cirelli,227,235,462,50,2,0.49134199134199136,89.0,78.0
20202021,Mathew Barzal,152,198,350,55,2,0.4342857142857143,147.0,104.0
20202021,Adam Lowry,361,354,715,52,2,0.5048951048951049,73.0,34.0
20202021,Isac Lundestrom,189,209,398,41,2,0.4748743718592965,112.0,94.0
20202021,Kevin Stenlund,103,115,218,32,2,0.4724770642201835,114.0,126.0
20202021,Eric Staal,268,279,547,53,2,0.489945155393053,90.0,62.0
20202021,Claude Giroux,484,328,812,54,2,0.5960591133004927,4.0,14.0
20202021,Alexandre Texier,128,228,356,49,2,0.3595505617977528,166.0,115.0
20202021,Ryan Johansen,424,398,822,48,2,0.5158150851581509,62.0,24.0
20202021,Patrick Marleau,141,159,300,56,2,0.47,117.0,108.0
20202021,Ross Colton,101,107,208,30,2,0.4855769230769231,99.0,128.0
20202021,Gabriel Landeskog,288,221,509,54,2,0.5658153241650294,14.0,54.0
20202021,Nick Bonino,365,326,691,55,2,0.5282199710564399,42.0,32.0
20202021,Michael McLeod,326,307,633,52,2,0.5150078988941548,63.0,41.0
20202021,Curtis Lazar,160,175,335,50,2,0.47761194029850745,108.0,101.0
20202021,Juho Lammikko,124,152,276,44,2,0.4492753623188406,138.0,118.0
20202021,Erik Haula,270,220,490,51,2,0.5510204081632653,27.0,60.0
20202021,Christian Dvorak,553,509,1062,56,2,0.5207156308851224,54.0,9.0
20202021,David Kampf,410,367,777,56,2,0.5276705276705277,44.0,25.0
20202021,Nazem Kadri,392,351,743,56,2,0.5275908479138627,45.0,27.0
20202021,William Karlsson,518,441,959,56,2,0.5401459854014599,33.0,11.0
20202021,Gaetan Haas,139,167,306,34,2,0.4542483660130719,133.0,109.0
20202021,Paul Stastny,324,268,592,56,2,0.5472972972972973,30.0,42.0
20202021,Barclay Goodrow,162,162,324,55,2,0.5,78.0,100.0
20202021,Matt Duchene,162,139,301,34,2,0.5382059800664452,35.0,100.0
20202021,David Krejci,321,271,592,51,2,0.5422297297297297,32.0,43.0
20202021,Nathan MacKinnon,239,254,493,48,2,0.4847870182555781,101.0,70.0
20202021,Sean Couturier,427,323,750,45,2,0.5693333333333334,11.0,23.0
20202021,Travis Zajac,310,293,603,46,2,0.5140961857379768,65.0,48.0
20202021,J.T. Compher,216,255,471,48,2,0.4585987261146497,129.0,83.0
20202021,Jean-Gabriel Pageau,472,361,833,54,2,0.5666266506602641,13.0,17.0
20202021,Kevin Rooney,197,241,438,54,2,0.4497716894977169,137.0,90.0
20202021,Radek Faksa,424,336,760,55,2,0.5578947368421052,20.0,24.0
20202021,Tyson Jost,162,184,346,54,2,0.4682080924855491,120.0,100.0
20202021,Mikhail Maltsev,74,86,160,33,2,0.4625,126.0,139.0
20202021,Teddy Blueger,201,212,413,43,2,0.48668280871670705,97.0,87.0
20202021,Colin White,170,232,402,45,2,0.4228855721393035,157.0,98.0
20202021,Nicklas Backstrom,353,378,731,55,2,0.4829001367989056,103.0,35.0
20202021,Brayden Point,257,263,520,56,2,0.49423076923076925,84.0,66.0
20202021,Phillip Danault,476,431,907,53,2,0.5248070562293274,49.0,16.0
20202021,Victor Rask,218,262,480,54,2,0.45416666666666666,134.0,81.0
20202021,Sam Gagner,83,97,180,42,2,0.46111111111111114,127.0,133.0
20202021,Max Domi,192,204,396,54,2,0.48484848484848486,100.0,92.0
20202021,J.T. Miller,279,247,526,53,2,0.5304182509505704,39.0,55.0
20202021,Scott Laughton,211,220,431,53,2,0.4895591647331787,93.0,84.0
20202021,Cody Eakin,271,228,499,46,2,0.5430861723446894,31.0,59.0
20202021,Jamie Benn,268,210,478,52,2,0.5606694560669456,18.0,62.0
20202021,Noel Acciari,272,247,519,41,2,0.5240847784200385,50.0,58.0
20202021,Nolan Patrick,226,204,430,52,2,0.5255813953488372,48.0,79.0
20202021,Dylan Larkin,361,369,730,44,2,0.4945205479452055,83.0,34.0
20202021,Charlie Coyle,245,262,507,51,2,0.4832347140039448,102.0,68.0
20202021,Tomas Nosek,200,187,387,38,2,0.5167958656330749,61.0,88.0
20202021,Nate Thompson,143,141,284,44,2,0.5035211267605634,76.0,106.0
20202021,Nick Suzuki,350,446,796,56,2,0.4396984924623116,142.0,37.0
20202021,Kyle Turris,97,107,204,27,2,0.47549019607843135,109.0,129.0
20202021,Robby Fabbri,83,107,190,30,2,0.4368421052631579,145.0,133.0
20202021,Nick Schmaltz,230,307,537,52,2,0.42830540037243947,151.0,76.0
20202021,Ivan Barbashev,82,107,189,38,2,0.43386243386243384,148.0,134.0
20202021,Mark Jankowski,151,172,323,45,2,0.4674922600619195,121.0,105.0
20202021,Lucas Wallmark,67,95,162,20,2,0.41358024691358025,160.0,141.0
20202021,Tyler Johnson,48,55,103,23,3,0.46601941747572817,46.0,30.0
20202021,T.J. Oshie,11,26,37,5,3,0.2972972972972973,68.0,54.0
20202021,Leo Komarov,24,27,51,19,3,0.47058823529411764,43.0,46.0
20202021,Evgeny Kuznetsov,17,25,42,3,3,0.40476190476190477,60.0,50.0
20202021,Curtis Lazar,36,30,66,10,3,0.5454545454545454,16.0,38.0
20202021,Ryan Hartman,43,45,88,7,3,0.48863636363636365,36.0,33.0
20202021,Jesperi Kotkaniemi,76,78,154,19,3,0.4935064935064935,32.0,17.0
20202021,Joel Eriksson Ek,57,71,128,7,3,0.4453125,53.0,24.0
20202021,Ryan Nugent-Hopkins,16,20,36,4,3,0.4444444444444444,54.0,51.0
20202021,Casey Cizikas,142,90,232,19,3,0.6120689655172413,4.0,5.0
20202021,Patrice Bergeron,135,112,247,11,3,0.5465587044534413,15.0,8.0
20202021,Pierre-Luc Dubois,22,25,47,7,3,0.46808510638297873,44.0,47.0
20202021,Jake Evans,20,19,39,7,3,0.5128205128205128,28.0,48.0
20202021,Nick Foligno,25,12,37,4,3,0.6756756756756757,1.0,45.0
20202021,Pierre Engvall,12,18,30,6,3,0.4,61.0,53.0
20202021,Sidney Crosby,54,74,128,6,3,0.421875,58.0,25.0
20202021,Chandler Stephenson,141,133,274,16,3,0.5145985401459854,27.0,6.0
20202021,Tyler Bozak,29,31,60,4,3,0.48333333333333334,39.0,44.0
20202021,Steven Stamkos,100,88,188,23,3,0.5319148936170213,21.0,11.0
20202021,Connor McDavid,19,23,42,4,3,0.4523809523809524,50.0,49.0
20202021,Jujhar Khaira,12,22,34,4,3,0.35294117647058826,67.0,53.0
20202021,Brock Nelson,110,122,232,19,3,0.47413793103448276,42.0,10.0
20202021,Aleksander Barkov,74,66,140,6,3,0.5285714285714286,22.0,19.0
20202021,Jordan Staal,132,94,226,11,3,0.584070796460177,6.0,9.0
20202021,Lars Eller,35,32,67,4,3,0.5223880597014925,23.0,39.0
20202021,Steven Lorentz,53,64,117,11,3,0.452991452991453,49.0,26.0
20202021,Colton Sissons,54,52,106,6,3,0.5094339622641509,29.0,25.0
20202021,Alex Wennberg,31,43,74,6,3,0.4189189189189189,59.0,42.0
20202021,Nicolas Roy,132,100,232,19,3,0.5689655172413793,10.0,9.0
20202021,Vincent Trocheck,79,68,147,9,3,0.5374149659863946,19.0,15.0
20202021,Mark Scheifele,62,57,119,5,3,0.5210084033613446,24.0,21.0
20202021,Leon Draisaitl,50,51,101,4,3,0.49504950495049505,31.0,28.0
20202021,Yanni Gourde,140,160,300,23,3,0.4666666666666667,45.0,7.0
20202021,Andrew Copp,39,34,73,8,3,0.5342465753424658,20.0,36.0
20202021,Jonathan Marchessault,12,29,41,19,3,0.2926829268292683,69.0,53.0
20202021,Anthony Cirelli,92,97,189,23,3,0.48677248677248675,37.0,13.0
20202021,Mathew Barzal,40,64,104,19,3,0.38461538461538464,66.0,35.0
20202021,Ryan O'Reilly,49,41,90,4,3,0.5444444444444444,17.0,29.0
20202021,Sean Kuraly,41,38,79,11,3,0.5189873417721519,25.0,34.0
20202021,Tyson Jost,38,59,97,10,3,0.3917525773195876,64.0,37.0
20202021,Teddy Blueger,25,31,56,6,3,0.44642857142857145,51.0,45.0
20202021,Brayden Point,140,128,268,23,3,0.5223880597014925,23.0,7.0
20202021,Nicklas Backstrom,38,42,80,5,3,0.475,41.0,37.0
20202021,Phillip Danault,273,231,504,22,3,0.5416666666666666,18.0,1.0
20202021,Victor Rask,33,50,83,7,3,0.39759036144578314,62.0,41.0
20202021,Alex Kerfoot,30,48,78,7,3,0.38461538461538464,66.0,43.0
20202021,Auston Matthews,94,77,171,7,3,0.5497076023391813,12.0,12.0
20202021,Adam Lowry,75,61,136,8,3,0.5514705882352942,11.0,18.0
20202021,Keegan Kolesar,19,29,48,17,3,0.3958333333333333,63.0,49.0
20202021,David Krejci,84,70,154,11,3,0.5454545454545454,16.0,14.0
20202021,Jean-Gabriel Pageau,189,156,345,19,3,0.5478260869565217,13.0,2.0
20202021,J.T. Compher,47,56,103,10,3,0.4563106796116505,48.0,31.0
20202021,Nathan MacKinnon,59,61,120,10,3,0.49166666666666664,33.0,23.0
20202021,Sebastian Aho,78,83,161,11,3,0.484472049689441,38.0,16.0
20202021,Brayden Schenn,9,24,33,4,3,0.2727272727272727,70.0,55.0
20202021,Patrick Brown,46,38,84,12,3,0.5476190476190477,14.0,32.0
20202021,Jason Spezza,24,25,49,7,3,0.4897959183673469,34.0,46.0
20202021,Paul Stastny,39,34,73,6,3,0.5342465753424658,20.0,36.0
20202021,Jeff Carter,60,44,104,6,3,0.5769230769230769,7.0,22.0
20202021,William Karlsson,180,134,314,19,3,0.5732484076433121,8.0,3.0
20202021,Eric Staal,74,93,167,21,3,0.4431137724550898,55.0,19.0
20202021,Barclay Goodrow,52,78,130,18,3,0.4,61.0,27.0
20202021,Mikael Granlund,53,66,119,6,3,0.44537815126050423,52.0,26.0
20202021,Sam Bennett,20,20,40,5,3,0.5,30.0,48.0
20202021,Gabriel Landeskog,72,48,120,10,3,0.6,5.0,20.0
20202021,Nick Bonino,22,35,57,7,3,0.38596491228070173,65.0,47.0
20202021,Erik Haula,48,45,93,6,3,0.5161290322580645,26.0,30.0
20202021,Noel Acciari,49,37,86,6,3,0.5697674418604651,9.0,29.0
20202021,Evgeni Malkin,14,19,33,4,3,0.42424242424242425,57.0,52.0
20202021,Nic Dowd,39,42,81,5,3,0.48148148148148145,40.0,36.0
20202021,Pierre-Edouard Bellemare,36,30,66,10,3,0.5454545454545454,16.0,38.0
20202021,Ryan Johansen,48,50,98,6,3,0.4897959183673469,34.0,30.0
20202021,Ross Colton,22,23,45,23,3,0.4888888888888889,35.0,47.0
20202021,Charlie Coyle,41,55,96,11,3,0.4270833333333333,56.0,34.0
20202021,Tomas Nosek,34,17,51,6,3,0.6666666666666666,2.0,40.0
20202021,Nick Suzuki,150,178,328,22,3,0.4573170731707317,47.0,4.0
20202021,Nate Thompson,22,13,35,8,3,0.6285714285714286,3.0,47.0
20212022,Yegor Sharangovich,89,131,220,76,2,0.40454545454545454,179.0,157.0
20212022,T.J. Oshie,72,97,169,44,2,0.4260355029585799,168.0,166.0
20212022,Evgeny Kuznetsov,507,659,1166,79,2,0.434819897084048,163.0,46.0
20212022,Riley Nash,207,190,397,49,2,0.5214105793450882,65.0,111.0
20212022,Evan Rodrigues,183,203,386,82,2,0.4740932642487047,127.0,120.0
20212022,Christian Dvorak,548,419,967,56,2,0.5667011375387797,16.0,36.0
20212022,Andrew Copp,377,332,709,72,2,0.5317348377997179,45.0,72.0
20212022,Colin Blackwell,83,86,169,58,2,0.4911242603550296,107.0,161.0
20212022,Brett Howden,140,151,291,47,2,0.48109965635738833,121.0,139.0
20212022,Roope Hintz,357,317,674,80,2,0.5296735905044511,50.0,77.0
20212022,Kevin Hayes,260,347,607,48,2,0.42833607907743,166.0,96.0
20212022,Curtis Lazar,136,142,278,70,2,0.4892086330935252,111.0,141.0
20212022,Ryan Hartman,513,631,1144,82,2,0.44842657342657344,152.0,43.0
20212022,Devin Shore,102,112,214,49,2,0.4766355140186916,124.0,154.0
20212022,Casey Mittelstadt,202,250,452,40,2,0.4469026548672566,154.0,114.0
20212022,Casey Cizikas,534,427,961,74,2,0.5556711758584808,26.0,40.0
20212022,Nick Bjugstad,141,114,255,57,2,0.5529411764705883,29.0,138.0
20212022,Joel Eriksson Ek,697,768,1465,77,2,0.4757679180887372,125.0,19.0
20212022,Ryan Nugent-Hopkins,178,259,437,63,2,0.4073226544622426,177.0,124.0
20212022,Blake Lizotte,313,294,607,70,2,0.515650741350906,70.0,83.0
20212022,Dylan Cozens,383,457,840,79,2,0.45595238095238094,144.0,71.0
20212022,Justin Danforth,107,92,199,45,2,0.5376884422110553,39.0,151.0
20212022,Victor Rask,89,87,176,47,2,0.5056818181818182,84.0,157.0
20212022,Patrice Bergeron,991,609,1600,73,2,0.619375,1.0,1.0
20212022,Pierre-Luc Dubois,532,603,1135,81,2,0.4687224669603524,131.0,41.0
20212022,Mark Jankowski,86,93,179,19,2,0.48044692737430167,122.0,159.0
20212022,Sean Kuraly,628,642,1270,77,2,0.494488188976378,101.0,27.0
20212022,Jake Evans,461,465,926,72,2,0.4978401727861771,94.0,54.0
20212022,Elias Lindholm,842,750,1592,82,2,0.5288944723618091,51.0,5.0
20212022,Greg McKegg,72,88,160,43,2,0.45,151.0,166.0
20212022,Nico Sturm,312,277,589,74,2,0.5297113752122241,49.0,84.0
20212022,Ryan Poehling,227,262,489,57,2,0.46421267893660534,137.0,103.0
20212022,Yanni Gourde,444,453,897,74,2,0.49498327759197325,99.0,57.0
20212022,Sidney Crosby,760,690,1450,69,2,0.5241379310344828,58.0,10.0
20212022,Steven Stamkos,545,523,1068,81,2,0.5102996254681648,79.0,38.0
20212022,Sam Carrick,204,209,413,64,2,0.4939467312348668,102.0,112.0
20212022,Pavel Zacha,189,188,377,70,2,0.5013262599469496,88.0,118.0
20212022,Jay Beagle,265,199,464,33,2,0.5711206896551724,10.0,93.0
20212022,Rasmus Kupari,129,174,303,57,2,0.42574257425742573,169.0,144.0
20212022,Chandler Stephenson,653,602,1255,79,2,0.5203187250996016,67.0,23.0
20212022,Michael McCarron,192,161,353,51,2,0.5439093484419264,34.0,117.0
20212022,Tyler Bozak,175,212,387,50,2,0.45219638242894056,149.0,126.0
20212022,Jake Leschyshyn,122,143,265,41,2,0.46037735849056605,143.0,147.0
20212022,Barclay Goodrow,366,375,741,79,2,0.4939271255060729,103.0,74.0
20212022,Ryan Getzlaf,546,479,1025,56,2,0.5326829268292683,44.0,37.0
20212022,Mark Scheifele,430,418,848,67,2,0.5070754716981132,82.0,60.0
20212022,Travis Boyd,420,507,927,74,2,0.45307443365695793,148.0,63.0
20212022,Leon Draisaitl,887,774,1661,80,2,0.5340156532209512,43.0,3.0
20212022,Bo Horvat,841,634,1475,70,2,0.5701694915254237,11.0,6.0
20212022,Claude Giroux,733,483,1216,75,2,0.602796052631579,3.0,13.0
20212022,Evgeni Malkin,164,212,376,41,2,0.43617021276595747,161.0,133.0
20212022,Elias Pettersson,238,302,540,80,2,0.44074074074074077,159.0,101.0
20212022,Nic Dowd,506,437,943,64,2,0.5365853658536586,41.0,47.0
20212022,Jared McCann,224,268,492,74,2,0.45528455284552843,145.0,105.0
20212022,Zemgus Girgensons,143,144,287,56,2,0.49825783972125437,93.0,136.0
20212022,Colton Sissons,719,573,1292,79,2,0.5565015479876161,24.0,15.0
20212022,Mikael Backlund,621,608,1229,82,2,0.5052888527257934,85.0,28.0
20212022,Vincent Trocheck,680,565,1245,81,2,0.5461847389558233,33.0,21.0
20212022,Nate Thompson,160,127,287,33,2,0.5574912891986062,23.0,134.0
20212022,Morgan Geekie,351,318,669,73,2,0.5246636771300448,55.0,79.0
20212022,Pius Suter,495,509,1004,82,2,0.49302788844621515,105.0,48.0
20212022,Dylan Strome,460,419,879,69,2,0.5233219567690558,60.0,55.0
20212022,Oskar Sundqvist,75,107,182,59,2,0.41208791208791207,175.0,165.0
20212022,Dillon Dube,92,102,194,79,2,0.4742268041237113,126.0,155.0
20212022,Mikael Granlund,569,637,1206,80,2,0.47180762852404645,129.0,32.0
20212022,Jason Dickinson,123,166,289,62,2,0.42560553633217996,170.0,146.0
20212022,Christian Fischer,76,147,223,53,2,0.34080717488789236,194.0,164.0
20212022,Filip Chytil,135,176,311,67,2,0.4340836012861736,164.0,142.0
20212022,Jack Eichel,184,195,379,34,2,0.48548812664907653,116.0,119.0
20212022,Joe Thornton,77,98,175,34,2,0.44,160.0,163.0
20212022,Sam Steel,203,209,412,68,2,0.49271844660194175,106.0,113.0
20212022,Mika Zibanejad,700,638,1338,81,2,0.523168908819133,63.0,17.0
20212022,Calle Jarnkrok,239,228,467,66,2,0.5117773019271948,74.0,100.0
20212022,Ryan Strome,363,455,818,74,2,0.44376528117359415,157.0,75.0
20212022,Connor McDavid,562,484,1046,80,2,0.5372848948374761,40.0,34.0
20212022,Derek Stepan,248,196,444,58,2,0.5585585585585585,22.0,97.0
20212022,Juho Lammikko,354,340,694,75,2,0.5100864553314121,80.0,78.0
20212022,Dawson Mercer,209,381,590,82,2,0.35423728813559324,190.0,110.0
20212022,Alex Kerfoot,76,102,178,82,2,0.42696629213483145,167.0,164.0
20212022,Auston Matthews,691,538,1229,73,2,0.5622457282343368,18.0,20.0
20212022,John Tavares,813,529,1342,79,2,0.6058122205663189,2.0,7.0
20212022,Robert Thomas,562,565,1127,72,2,0.4986690328305235,92.0,34.0
20212022,Boone Jenner,642,556,1198,59,2,0.5358931552587646,42.0,25.0
20212022,Ryan McLeod,248,277,525,71,2,0.4723809523809524,128.0,97.0
20212022,Josh Norris,529,507,1036,66,2,0.5106177606177607,76.0,42.0
20212022,Brock Nelson,476,488,964,72,2,0.49377593360995853,104.0,52.0
20212022,Aleksander Barkov,713,539,1252,67,2,0.5694888178913738,13.0,16.0
20212022,Lars Eller,510,521,1031,72,2,0.49466537342386036,100.0,44.0
20212022,Tim St√ºtzle,180,293,473,79,2,0.38054968287526425,188.0,122.0
20212022,Kirby Dach,179,366,545,70,2,0.3284403669724771,195.0,123.0
20212022,Nicolas Roy,454,477,931,78,2,0.48764769065520946,113.0,56.0
20212022,Sam Reinhart,174,185,359,78,2,0.48467966573816157,117.0,127.0
20212022,Jesper Boqvist,168,282,450,56,2,0.37333333333333335,189.0,131.0
20212022,Michael Rasmussen,410,409,819,80,2,0.5006105006105006,90.0,66.0
20212022,Joe Pavelski,394,357,751,82,2,0.5246338215712384,56.0,68.0
20212022,Derek Grant,204,216,420,71,2,0.4857142857142857,115.0,112.0
20212022,Joe Veleno,222,238,460,66,2,0.4826086956521739,119.0,106.0
20212022,Jack Hughes,122,231,353,49,2,0.34560906515580736,193.0,147.0
20212022,Jordan Staal,736,549,1285,78,2,0.5727626459143969,8.0,12.0
20212022,Mikko Rantanen,164,190,354,75,2,0.4632768361581921,140.0,133.0
20212022,Mikko Rantanen,164,190,354,75,2,0.4632768361581921,140.0,133.0
20212022,Chris Tierney,264,267,531,70,2,0.4971751412429379,96.0,94.0
20212022,Vincent Trocheck,680,565,1245,81,2,0.5461847389558233,33.0,21.0
20212022,Nate Thompson,160,127,287,33,2,0.5574912891986062,23.0,134.0
20212022,Morgan Geekie,351,318,669,73,2,0.5246636771300448,55.0,79.0
20212022,Pius Suter,495,509,1004,82,2,0.49302788844621515,105.0,48.0
20212022,Sebastian Aho,555,504,1059,79,2,0.5240793201133145,59.0,35.0
20212022,Brayden Schenn,284,295,579,62,2,0.4905008635578584,109.0,90.0
20212022,Peyton Krebs,61,112,173,57,2,0.35260115606936415,191.0,169.0
20212022,Brady Tkachuk,218,217,435,79,2,0.5011494252873563,89.0,107.0
20212022,Jesperi Kotkaniemi,176,168,344,66,2,0.5116279069767442,75.0,125.0
20212022,Tyson Jost,172,254,426,80,2,0.40375586854460094,181.0,129.0
20212022,Anthony Cirelli,441,507,948,76,2,0.4651898734177215,135.0,58.0
20212022,Mathew Barzal,234,271,505,73,2,0.4633663366336634,139.0,102.0
20212022,Henrik Borgstrom,82,122,204,52,2,0.4019607843137255,183.0,162.0
20212022,Nicholas Paul,426,419,845,80,2,0.5041420118343195,87.0,61.0
20212022,Ryan O'Reilly,900,685,1585,78,2,0.5678233438485805,15.0,2.0
20212022,Tomas Hertl,769,697,1466,82,2,0.524556616643929,57.0,9.0
20212022,Anze Kopitar,858,651,1509,81,2,0.5685884691848907,14.0,4.0
20212022,Jeff Skinner,91,133,224,80,2,0.40625,178.0,156.0
20212022,Sam Bennett,411,466,877,71,2,0.46864310148232613,132.0,65.0
20212022,Tyler Seguin,464,364,828,81,2,0.5603864734299517,20.0,53.0
20212022,Nico Hischier,730,672,1402,70,2,0.5206847360912982,66.0,14.0
20212022,Nolan Patrick,83,89,172,25,2,0.48255813953488375,120.0,161.0
20212022,Eetu Luostarinen,321,481,802,78,2,0.4002493765586035,184.0,82.0
20212022,Adam Ruzicka,103,120,223,28,2,0.4618834080717489,142.0,153.0
20212022,Brian Boyle,165,200,365,66,2,0.4520547945205479,150.0,132.0
20212022,Adam Henrique,276,221,497,58,2,0.5553319919517102,27.0,91.0
20212022,Jason Spezza,305,272,577,71,2,0.5285961871750433,53.0,85.0
20212022,Sean Monahan,414,365,779,65,2,0.5314505776636713,46.0,64.0
20212022,Connor McMichael,148,197,345,68,2,0.4289855072463768,165.0,135.0
20212022,Jack Roslovic,372,483,855,81,2,0.43508771929824563,162.0,73.0
20212022,Reese Johnson,107,105,212,37,2,0.5047169811320755,86.0,151.0
20212022,Alex Galchenyuk,214,195,409,60,2,0.5232273838630807,62.0,109.0
20212022,Adam Lowry,564,500,1064,79,2,0.5300751879699248,48.0,33.0
20212022,Isac Lundestrom,391,488,879,80,2,0.4448236632536974,156.0,70.0
20212022,Ryan Dzingel,65,88,153,32,2,0.42483660130718953,171.0,168.0
20212022,Derek Ryan,286,226,512,75,2,0.55859375,21.0,89.0
20212022,Morgan Frost,226,241,467,55,2,0.48394004282655245,118.0,104.0
20212022,Brad Richardson,139,100,239,44,2,0.5815899581589958,7.0,140.0
20212022,Cole Sillinger,362,417,779,79,2,0.46469833119383824,136.0,76.0
20212022,Trevor Lewis,77,105,182,80,2,0.4230769230769231,173.0,163.0
20212022,Ryan Johansen,691,622,1313,79,2,0.5262757044935262,54.0,20.0
20212022,David Kampf,616,549,1165,82,2,0.5287553648068669,52.0,29.0
20212022,Ross Colton,303,278,581,79,2,0.5215146299483648,64.0,86.0
20212022,Gabriel Landeskog,241,198,439,51,2,0.5489749430523918,32.0,99.0
20212022,Michael McLeod,604,451,1055,77,2,0.5725118483412323,9.0,30.0
20212022,Tage Thompson,393,582,975,78,2,0.40307692307692305,182.0,69.0
20212022,Derick Brassard,169,161,330,46,2,0.5121212121212121,73.0,130.0
20212022,Trevor Zegras,217,327,544,75,2,0.39889705882352944,186.0,108.0
20212022,Darren Helm,103,130,233,68,2,0.44206008583690987,158.0,153.0
20212022,Patrick Brown,242,172,414,44,2,0.5845410628019324,6.0,98.0
20212022,Nazem Kadri,585,592,1177,71,2,0.4970263381478335,97.0,31.0
20212022,Paul Stastny,267,205,472,71,2,0.565677966101695,17.0,92.0
20212022,Jeff Carter,648,489,1137,76,2,0.5699208443271768,12.0,24.0
20212022,William Karlsson,508,475,983,67,2,0.5167853509664293,68.0,45.0
20212022,Jonathan Toews,788,548,1336,71,2,0.5898203592814372,4.0,8.0
20212022,Luke Glendening,425,299,724,82,2,0.5870165745856354,5.0,62.0
20212022,Kyle Okposo,92,93,185,74,2,0.4972972972972973,95.0,155.0
20212022,Matt Duchene,119,101,220,78,2,0.5409090909090909,36.0,148.0
20212022,Johan Larsson,195,227,422,43,2,0.46208530805687204,141.0,116.0
20212022,Keegan Kolesar,76,112,188,77,2,0.40425531914893614,180.0,164.0
20212022,Quinton Byfield,124,149,273,40,2,0.4542124542124542,146.0,145.0
20212022,Dominic Toninato,87,118,205,77,2,0.424390243902439,172.0,158.0
20212022,Nathan MacKinnon,383,461,844,65,2,0.4537914691943128,147.0,71.0
20212022,Sean Couturier,238,190,428,29,2,0.5560747663551402,25.0,101.0
20212022,Frederick Gaudreau,461,461,922,76,2,0.5,91.0,54.0
20212022,J.T. Compher,338,319,657,70,2,0.5144596651445966,72.0,80.0
20212022,Jean-Gabriel Pageau,748,604,1352,77,2,0.5532544378698225,28.0,11.0
20212022,Pierre-Edouard Bellemare,483,452,935,80,2,0.5165775401069519,69.0,50.0
20212022,Anton Lundell,334,414,748,65,2,0.446524064171123,155.0,81.0
20212022,Kevin Rooney,181,223,404,61,2,0.44801980198019803,153.0,121.0
20212022,Alex Newhook,136,256,392,71,2,0.3469387755102041,192.0,141.0
20212022,Logan Brown,66,102,168,39,2,0.39285714285714285,187.0,167.0
20212022,Radek Faksa,383,312,695,77,2,0.5510791366906475,31.0,71.0
20212022,Teddy Blueger,357,315,672,65,2,0.53125,47.0,77.0
20212022,Colin White,86,91,177,24,2,0.4858757062146893,114.0,159.0
20212022,Erik Haula,434,372,806,78,2,0.5384615384615384,38.0,59.0
20212022,Nicklas Backstrom,301,348,649,47,2,0.4637904468412943,138.0,87.0
20212022,Brayden Point,366,351,717,66,2,0.5104602510460251,77.0,74.0
20212022,Dylan Gambrell,295,309,604,63,2,0.48841059602649006,112.0,88.0
20212022,Sam Gagner,142,162,304,81,2,0.46710526315789475,133.0,137.0
20212022,Ryan Carpenter,200,188,388,67,2,0.5154639175257731,71.0,115.0
20212022,Sam Lafferty,108,155,263,56,2,0.41064638783269963,176.0,150.0
20212022,Jasper Weatherby,173,168,341,50,2,0.5073313782991202,81.0,128.0
20212022,Mitchell Stephens,124,129,253,27,2,0.4901185770750988,110.0,145.0
20212022,J.T. Miller,667,566,1233,80,2,0.5409570154095702,35.0,22.0
20212022,Scott Laughton,395,379,774,67,2,0.5103359173126615,78.0,67.0
20212022,Tomas Nosek,362,309,671,75,2,0.5394932935916542,37.0,76.0
20212022,Laurent Dauphin,104,143,247,38,2,0.42105263157894735,174.0,152.0
20212022,Cody Eakin,482,378,860,69,2,0.5604651162790698,19.0,51.0
20212022,Jamie Benn,492,399,891,82,2,0.5521885521885522,30.0,49.0
20212022,Noel Acciari,84,82,166,20,2,0.5060240963855421,83.0,160.0
20212022,Dylan Larkin,630,574,1204,71,2,0.5232558139534884,61.0,26.0
20212022,Charlie Coyle,540,560,1100,82,2,0.4909090909090909,108.0,39.0
20212022,Alex Wennberg,555,635,1190,80,2,0.46638655462184875,134.0,35.0
20212022,Nick Suzuki,699,711,1410,82,2,0.4957446808510638,98.0,18.0
20212022,Nick Schmaltz,114,125,239,63,2,0.4769874476987448,123.0,149.0
20212022,Ivan Barbashev,131,197,328,81,2,0.39939024390243905,185.0,143.0
20212022,Riley Sheahan,263,296,559,69,2,0.47048300536672627,130.0,95.0
20212022,T.J. Oshie,17,18,35,6,3,0.4857142857142857,42.0,48.0
20212022,Evgeny Kuznetsov,38,51,89,6,3,0.42696629213483145,60.0,37.0
20212022,Roope Hintz,23,32,55,6,3,0.41818181818181815,64.0,46.0
20212022,Curtis Lazar,19,28,47,7,3,0.40425531914893614,66.0,47.0
20212022,Ryan Hartman,35,45,80,6,3,0.4375,57.0,39.0
20212022,Joel Eriksson Ek,48,53,101,6,3,0.4752475247524752,45.0,31.0
20212022,Ryan Nugent-Hopkins,73,99,172,16,3,0.42441860465116277,62.0,23.0
20212022,Blake Lizotte,33,40,73,7,3,0.4520547945205479,51.0,40.0
20212022,Patrice Bergeron,85,76,161,7,3,0.5279503105590062,25.0,20.0
20212022,Calle Jarnkrok,69,76,145,12,3,0.47586206896551725,44.0,25.0
20212022,Andrew Copp,96,120,216,20,3,0.4444444444444444,55.0,14.0
20212022,Elias Lindholm,141,115,256,12,3,0.55078125,16.0,7.0
20212022,Brandon Hagel,17,18,35,23,3,0.4857142857142857,42.0,48.0
20212022,Sidney Crosby,80,70,150,6,3,0.5333333333333333,23.0,21.0
20212022,Steven Stamkos,169,142,311,23,3,0.5434083601286174,18.0,3.0
20212022,Rasmus Kupari,17,18,35,5,3,0.4857142857142857,42.0,48.0
20212022,Tyler Bozak,31,24,55,12,3,0.5636363636363636,11.0,41.0
20212022,Mika Zibanejad,207,199,406,20,3,0.5098522167487685,33.0,1.0
20212022,Connor McDavid,92,83,175,16,3,0.5257142857142857,27.0,16.0
20212022,Ryan Strome,65,88,153,19,3,0.42483660130718953,61.0,27.0
20212022,Lars Eller,49,42,91,6,3,0.5384615384615384,20.0,30.0
20212022,Jordan Staal,159,107,266,14,3,0.5977443609022557,4.0,5.0
20212022,Mikko Rantanen,26,36,62,20,3,0.41935483870967744,63.0,44.0
20212022,Nico Sturm,12,27,39,13,3,0.3076923076923077,71.0,50.0
20212022,Aleksander Barkov,105,84,189,10,3,0.5555555555555556,13.0,13.0
20212022,Colton Sissons,36,36,72,4,3,0.5,36.0,38.0
20212022,Mikael Backlund,119,102,221,12,3,0.5384615384615384,20.0,11.0
20212022,Phillip Danault,69,65,134,7,3,0.5149253731343284,30.0,25.0
20212022,Barclay Goodrow,36,54,90,9,3,0.4,67.0,38.0
20212022,Sam Reinhart,17,19,36,10,3,0.4722222222222222,47.0,48.0
20212022,Vincent Trocheck,120,86,206,14,3,0.5825242718446602,9.0,10.0
20212022,Leon Draisaitl,143,151,294,16,3,0.48639455782312924,41.0,6.0
20212022,Auston Matthews,69,56,125,7,3,0.552,14.0,25.0
20212022,John Tavares,73,39,112,7,3,0.6517857142857143,2.0,23.0
20212022,Joe Pavelski,36,33,69,7,3,0.5217391304347826,28.0,38.0
20212022,Tyson Jost,23,28,51,6,3,0.45098039215686275,52.0,46.0
20212022,Sam Bennett,41,42,83,10,3,0.4939759036144578,39.0,35.0
20212022,Tyler Seguin,49,36,85,7,3,0.5764705882352941,10.0,30.0
20212022,Eetu Luostarinen,40,36,76,10,3,0.5263157894736842,26.0,36.0
20212022,Nazem Kadri,94,93,187,16,3,0.5026737967914439,35.0,15.0
20212022,Jeff Carter,62,36,98,7,3,0.6326530612244898,3.0,28.0
20212022,Tomas Nosek,24,17,41,7,3,0.5853658536585366,8.0,45.0
20212022,Sebastian Aho,86,83,169,14,3,0.5088757396449705,34.0,19.0
20212022,Brayden Schenn,44,47,91,12,3,0.4835164835164835,43.0,33.0
20212022,Robert Thomas,88,89,177,12,3,0.4971751412429379,38.0,18.0
20212022,Ryan McLeod,80,98,178,16,3,0.449438202247191,53.0,21.0
20212022,Jesperi Kotkaniemi,70,57,127,14,3,0.5511811023622047,15.0,24.0
20212022,Trevor Lewis,29,30,59,12,3,0.4915254237288136,40.0,42.0
20212022,Ryan Johansen,36,33,69,4,3,0.5217391304347826,28.0,38.0
20212022,David Kampf,66,57,123,7,3,0.5365853658536586,21.0,26.0
20212022,Ross Colton,27,35,62,23,3,0.43548387096774194,58.0,43.0
20212022,Pierre-Edouard Bellemare,88,82,170,23,3,0.5176470588235295,29.0,18.0
20212022,Kevin Rooney,50,65,115,15,3,0.43478260869565216,59.0,29.0
20212022,Alex Newhook,8,24,32,12,3,0.25,72.0,51.0
20212022,Anton Lundell,24,21,45,9,3,0.5333333333333333,23.0,45.0
20212022,Nicholas Paul,190,192,382,23,3,0.4973821989528796,37.0,2.0
20212022,Mikael Granlund,43,41,84,4,3,0.5119047619047619,32.0,34.0
20212022,Filip Chytil,38,71,109,20,3,0.3486238532110092,70.0,37.0
20212022,Gabriel Landeskog,135,95,230,20,3,0.5869565217391305,6.0,9.0
20212022,Claude Giroux,69,56,125,10,3,0.552,14.0,25.0
20212022,Darren Helm,90,105,195,20,3,0.46153846153846156,49.0,17.0
20212022,Charlie Coyle,35,49,84,7,3,0.4166666666666667,65.0,39.0
20212022,Evgeni Malkin,46,41,87,7,3,0.5287356321839081,24.0,32.0
20212022,Nic Dowd,38,36,74,6,3,0.5135135135135135,31.0,37.0
20212022,Derek Ryan,77,60,137,15,3,0.5620437956204379,12.0,22.0
20212022,Nathan MacKinnon,139,154,293,20,3,0.47440273037542663,46.0,8.0
20212022,J.T. Compher,88,99,187,20,3,0.47058823529411764,48.0,18.0
20212022,Frederick Gaudreau,44,31,75,6,3,0.5866666666666667,7.0,33.0
20212022,Jamie Benn,40,47,87,7,3,0.45977011494252873,50.0,36.0
20212022,Ivan Barbashev,14,24,38,12,3,0.3684210526315789,68.0,49.0
20212022,Anthony Cirelli,113,140,253,23,3,0.44664031620553357,54.0,12.0
20212022,Ryan O'Reilly,161,134,295,12,3,0.5457627118644067,17.0,4.0
20212022,Anze Kopitar,92,80,172,7,3,0.5348837209302325,22.0,16.0
20212022,Radek Faksa,48,33,81,7,3,0.5925925925925926,5.0,31.0
20212022,Teddy Blueger,44,20,64,7,3,0.6875,1.0,33.0
20212022,Erik Haula,44,37,81,7,3,0.5432098765432098,19.0,33.0
20212022,Brayden Point,43,55,98,9,3,0.4387755102040816,56.0,34.0
20212022,Nicklas Backstrom,26,48,74,6,3,0.35135135135135137,69.0,44.0
20222023,Martin Necas,188,229,417,82,2,0.45083932853717024,145.0,115.0
20222023,T.J. Oshie,83,97,180,58,2,0.46111111111111114,133.0,153.0
20222023,Evgeny Kuznetsov,508,561,1069,81,2,0.4752104770813845,112.0,45.0
20222023,Christian Dvorak,477,440,917,64,2,0.520174482006543,55.0,54.0
20222023,Pavel Buchnevich,64,150,214,63,2,0.29906542056074764,182.0,159.0
20222023,Brett Howden,117,110,227,54,2,0.5154185022026432,59.0,139.0
20222023,Roope Hintz,249,230,479,73,2,0.5198329853862212,57.0,100.0
20222023,Kevin Hayes,334,342,676,81,2,0.4940828402366864,88.0,84.0
20222023,Cody Glass,362,365,727,72,2,0.49793672627235214,84.0,73.0
20222023,Andrew Copp,647,652,1299,82,2,0.4980754426481909,83.0,20.0
20222023,Noel Acciari,337,289,626,77,2,0.5383386581469649,36.0,82.0
20222023,Ryan Hartman,242,322,564,59,2,0.42907801418439717,161.0,102.0
20222023,Devin Shore,89,86,175,47,2,0.5085714285714286,73.0,149.0
20222023,Casey Mittelstadt,338,398,736,82,2,0.4592391304347826,134.0,81.0
20222023,Casey Cizikas,501,438,939,81,2,0.5335463258785943,44.0,47.0
20222023,Mikael Granlund,171,213,384,79,2,0.4453125,147.0,122.0
20222023,Joel Eriksson Ek,684,702,1386,78,2,0.4935064935064935,90.0,17.0
20222023,Laurent Dauphin,84,73,157,21,2,0.535031847133758,42.0,152.0
20222023,Ryan Nugent-Hopkins,308,374,682,82,2,0.45161290322580644,142.0,87.0
20222023,Blake Lizotte,413,394,807,81,2,0.5117719950433705,67.0,66.0
20222023,Jonathan Drouin,169,211,380,58,2,0.44473684210526315,149.0,123.0
20222023,Dylan Cozens,567,607,1174,81,2,0.4829642248722317,102.0,34.0
20222023,Mark Jankowski,191,152,343,50,2,0.5568513119533528,22.0,114.0
20222023,Lukas Sedlak,88,102,190,30,2,0.4631578947368421,131.0,150.0
20222023,Sean Monahan,177,144,321,25,2,0.5514018691588785,24.0,120.0
20222023,Patrice Bergeron,1043,663,1706,78,2,0.6113716295427901,2.0,1.0
20222023,Tyson Jost,175,276,451,71,2,0.38802660753880264,173.0,121.0
20222023,Steven Lorentz,262,285,547,80,2,0.4789762340036563,107.0,97.0
20222023,Pierre-Luc Dubois,483,505,988,73,2,0.4888663967611336,97.0,53.0
20222023,Colin White,84,111,195,68,2,0.4307692307692308,159.0,152.0
20222023,Sean Kuraly,567,575,1142,71,2,0.4964973730297723,86.0,34.0
20222023,Jake Evans,338,312,650,54,2,0.52,56.0,81.0
20222023,Elias Lindholm,857,681,1538,80,2,0.5572171651495449,20.0,5.0
20222023,Brock Nelson,490,547,1037,82,2,0.4725168756027001,120.0,51.0
20222023,Aleksander Barkov,731,601,1332,68,2,0.5487987987987988,27.0,11.0
20222023,Tim St√ºtzle,202,284,486,78,2,0.4156378600823045,168.0,113.0
20222023,Vincent Trocheck,721,565,1286,82,2,0.5606531881804043,16.0,12.0
20222023,Nikita Alexandrov,53,97,150,28,2,0.35333333333333333,179.0,161.0
20222023,Nicolas Roy,369,399,768,65,2,0.48046875,105.0,71.0
20222023,Sam Reinhart,236,230,466,82,2,0.5064377682403434,77.0,104.0
20222023,Jesper Boqvist,66,133,199,70,2,0.3316582914572864,181.0,158.0
20222023,Michael Rasmussen,203,195,398,56,2,0.5100502512562815,71.0,112.0
20222023,Joe Pavelski,368,321,689,82,2,0.5341074020319303,43.0,72.0
20222023,Robert Thomas,646,575,1221,73,2,0.5290745290745291,48.0,21.0
20222023,Boone Jenner,758,628,1386,68,2,0.5468975468975469,29.0,9.0
20222023,Ryan McLeod,288,310,598,57,2,0.4816053511705686,104.0,91.0
20222023,Ryan Strome,402,516,918,82,2,0.43790849673202614,155.0,68.0
20222023,Erik Haula,573,484,1057,80,2,0.5421002838221382,34.0,33.0
20222023,Joe Veleno,277,374,651,81,2,0.4254992319508449,162.0,94.0
20222023,Yanni Gourde,483,489,972,81,2,0.49691358024691357,85.0,53.0
20222023,Sidney Crosby,978,868,1846,82,2,0.5297941495124594,47.0,2.0
20222023,Steven Stamkos,501,430,931,81,2,0.5381310418904404,37.0,47.0
20222023,Matty Beniers,409,560,969,80,2,0.42208462332301344,166.0,67.0
20222023,Sam Carrick,182,187,369,52,2,0.4932249322493225,91.0,117.0
20222023,Barclay Goodrow,272,321,593,82,2,0.45868465430016864,135.0,95.0
20222023,Mark Scheifele,579,628,1207,81,2,0.47970173985086995,106.0,32.0
20222023,Travis Boyd,502,654,1156,82,2,0.4342560553633218,156.0,46.0
20222023,Leon Draisaitl,807,663,1470,80,2,0.5489795918367347,26.0,8.0
20222023,Sam Steel,308,325,633,65,2,0.48657187993680884,99.0,87.0
20222023,Paul Stastny,280,206,486,73,2,0.5761316872427984,11.0,93.0
20222023,Filip Chytil,251,380,631,74,2,0.3977812995245642,171.0,99.0
20222023,Jack Eichel,359,434,793,67,2,0.4527112232030265,139.0,75.0
20222023,Rasmus Kupari,220,183,403,66,2,0.5459057071960298,30.0,108.0
20222023,Chandler Stephenson,675,487,1162,81,2,0.580895008605852,10.0,18.0
20222023,Jason Dickinson,368,403,771,78,2,0.4773022049286641,110.0,72.0
20222023,Alex Belzile,96,109,205,31,2,0.4682926829268293,124.0,145.0
20222023,Zemgus Girgensons,94,113,207,80,2,0.45410628019323673,138.0,147.0
20222023,Colton Sissons,593,515,1108,82,2,0.5351985559566786,41.0,28.0
20222023,Mikael Backlund,705,681,1386,82,2,0.5086580086580087,72.0,15.0
20222023,Logan Couture,640,709,1349,82,2,0.4744255003706449,115.0,22.0
20222023,Barrett Hayton,628,602,1230,82,2,0.510569105691057,70.0,24.0
20222023,Sebastian Aho,531,503,1034,75,2,0.5135396518375241,64.0,38.0
20222023,Brayden Schenn,472,542,1014,82,2,0.46548323471400394,127.0,56.0
20222023,Brady Tkachuk,370,395,765,82,2,0.48366013071895425,101.0,70.0
20222023,MacKenzie Entwistle,93,107,200,66,2,0.465,128.0,148.0
20222023,Jesperi Kotkaniemi,360,340,700,82,2,0.5142857142857142,62.0,74.0
20222023,Anthony Cirelli,427,404,831,58,2,0.5138387484957883,63.0,61.0
20222023,Jack Studnicka,77,84,161,48,2,0.4782608695652174,109.0,155.0
20222023,Mathew Barzal,104,188,292,58,2,0.3561643835616438,177.0,142.0
20222023,Cole Guttman,88,81,169,14,2,0.5207100591715976,54.0,150.0
20222023,Chris Tierney,111,125,236,36,2,0.4703389830508475,121.0,140.0
20222023,Jujhar Khaira,154,164,318,51,2,0.48427672955974843,100.0,126.0
20222023,Phillip Danault,692,581,1273,82,2,0.5435978004713276,32.0,16.0
20222023,Claude Giroux,712,509,1221,82,2,0.5831285831285832,9.0,14.0
20222023,Vladislav Namestnikov,77,128,205,77,2,0.375609756097561,176.0,155.0
20222023,Eric Staal,343,400,743,72,2,0.4616419919246299,132.0,79.0
20222023,Ryan Poehling,186,225,411,53,2,0.45255474452554745,141.0,116.0
20222023,Morgan Geekie,297,307,604,69,2,0.4917218543046358,95.0,90.0
20222023,Pius Suter,214,243,457,79,2,0.4682713347921225,125.0,110.0
20222023,Derick Brassard,143,143,286,62,2,0.5,81.0,129.0
20222023,Evgeni Malkin,422,434,856,82,2,0.4929906542056075,92.0,63.0
20222023,Elias Pettersson,442,555,997,80,2,0.44332998996990974,151.0,58.0
20222023,Jayson Megna,146,133,279,55,2,0.5232974910394266,51.0,127.0
20222023,Nic Dowd,433,419,852,65,2,0.5082159624413145,74.0,60.0
20222023,Mika Zibanejad,692,706,1398,82,2,0.4949928469241774,87.0,16.0
20222023,Connor McDavid,525,486,1011,82,2,0.5192878338278932,58.0,40.0
20222023,Jack Hughes,164,300,464,78,2,0.35344827586206895,178.0,124.0
20222023,Jordan Staal,821,653,1474,81,2,0.5569877883310719,21.0,6.0
20222023,Mikko Rantanen,222,231,453,82,2,0.4900662251655629,96.0,107.0
20222023,Derek Stepan,229,193,422,73,2,0.542654028436019,33.0,106.0
20222023,Vladislav Namestnikov,77,128,205,77,2,0.375609756097561,176.0,155.0
20222023,Eric Staal,343,400,743,72,2,0.4616419919246299,132.0,79.0
20222023,Ryan Poehling,186,225,411,53,2,0.45255474452554745,141.0,116.0
20222023,Morgan Geekie,297,307,604,69,2,0.4917218543046358,95.0,90.0
20222023,Pius Suter,214,243,457,79,2,0.4682713347921225,125.0,110.0
20222023,Derick Brassard,143,143,286,62,2,0.5,81.0,129.0
20222023,Evgeni Malkin,422,434,856,82,2,0.4929906542056075,92.0,63.0
20222023,Elias Pettersson,442,555,997,80,2,0.44332998996990974,151.0,58.0
20222023,Jayson Megna,146,133,279,55,2,0.5232974910394266,51.0,127.0
20222023,Nic Dowd,433,419,852,65,2,0.5082159624413145,74.0,60.0
20222023,Jeff Skinner,142,158,300,79,2,0.47333333333333333,117.0,130.0
20222023,Sam Bennett,425,479,904,63,2,0.47013274336283184,122.0,62.0
20222023,Tyler Seguin,476,394,870,76,2,0.5471264367816092,28.0,55.0
20222023,Nico Hischier,891,763,1654,81,2,0.5386940749697703,35.0,4.0
20222023,Mark Kastelic,336,254,590,65,2,0.5694915254237288,13.0,83.0
20222023,Eetu Luostarinen,175,243,418,82,2,0.41866028708133973,167.0,121.0
20222023,Adam Ruzicka,83,91,174,44,2,0.47701149425287354,111.0,153.0
20222023,Adam Henrique,342,327,669,62,2,0.5112107623318386,69.0,80.0
20222023,Noah Cates,416,638,1054,82,2,0.3946869070208729,172.0,65.0
20222023,Reese Johnson,120,106,226,57,2,0.5309734513274337,46.0,136.0
20222023,Jack Roslovic,400,489,889,77,2,0.4499437570303712,146.0,69.0
20222023,Adam Lowry,595,585,1180,82,2,0.5042372881355932,78.0,26.0
20222023,Max Domi,510,440,950,80,2,0.5368421052631579,38.0,43.0
20222023,Isac Lundestrom,286,316,602,61,2,0.4750830564784053,113.0,92.0
20222023,Wyatt Johnston,145,190,335,82,2,0.43283582089552236,157.0,128.0
20222023,Derek Ryan,217,217,434,80,2,0.5,81.0,109.0
20222023,Morgan Frost,436,515,951,81,2,0.45846477392218715,136.0,59.0
20222023,Bo Horvat,958,727,1685,79,2,0.568545994065282,14.0,3.0
20222023,Cole Sillinger,308,388,696,64,2,0.4425287356321839,152.0,87.0
20222023,Trevor Lewis,131,178,309,82,2,0.42394822006472493,164.0,135.0
20222023,Nazem Kadri,586,648,1234,82,2,0.47487844408427876,114.0,31.0
20222023,Ryan Johansen,502,346,848,55,2,0.5919811320754716,7.0,46.0
20222023,Nils Aman,181,293,474,68,2,0.3818565400843882,175.0,118.0
20222023,David Kampf,591,556,1147,82,2,0.5152571926765476,60.0,29.0
20222023,Ross Colton,106,83,189,81,2,0.5608465608465608,15.0,141.0
20222023,Nick Bonino,217,233,450,62,2,0.4822222222222222,103.0,109.0
20222023,Austin Czarnik,69,91,160,29,2,0.43125,158.0,157.0
20222023,Michael McLeod,587,381,968,80,2,0.606404958677686,3.0,30.0
20222023,Andreas Athanasiou,81,93,174,81,2,0.46551724137931033,126.0,154.0
20222023,Evan Rodrigues,119,122,241,69,2,0.49377593360995853,89.0,137.0
20222023,Tage Thompson,350,463,813,78,2,0.43050430504305043,160.0,78.0
20222023,Trevor Zegras,237,336,573,81,2,0.41361256544502617,169.0,103.0
20222023,Jeff Carter,557,381,938,79,2,0.593816631130064,5.0,35.0
20222023,William Karlsson,632,510,1142,82,2,0.553415061295972,23.0,23.0
20222023,Jonathan Toews,594,347,941,53,2,0.6312433581296493,1.0,27.0
20222023,Luke Glendening,359,249,608,70,2,0.5904605263157895,8.0,75.0
20222023,Kyle Okposo,164,186,350,75,2,0.4685714285714286,123.0,124.0
20222023,Matt Duchene,137,122,259,71,2,0.528957528957529,49.0,133.0
20222023,Lars Eller,549,474,1023,84,2,0.5366568914956011,40.0,36.0
20222023,Peyton Krebs,251,305,556,74,2,0.45143884892086333,143.0,99.0
20222023,Teddy Blueger,299,276,575,63,2,0.52,56.0,89.0
20222023,Kirby Dach,87,140,227,58,2,0.3832599118942731,174.0,151.0
20222023,David Krejci,351,389,740,70,2,0.4743243243243243,116.0,77.0
20222023,Nathan MacKinnon,519,649,1168,71,2,0.4443493150684932,150.0,42.0
20222023,Jean-Gabriel Pageau,719,537,1256,70,2,0.572452229299363,12.0,13.0
20222023,Frederick Gaudreau,500,515,1015,82,2,0.49261083743842365,94.0,48.0
20222023,J.T. Compher,813,852,1665,82,2,0.4882882882882883,98.0,7.0
20222023,Pierre-Edouard Bellemare,322,294,616,73,2,0.5227272727272727,52.0,85.0
20222023,Anton Lundell,269,310,579,73,2,0.46459412780656306,130.0,96.0
20222023,Alex Newhook,208,295,503,82,2,0.4135188866799205,170.0,111.0
20222023,Ty Dellandrea,102,99,201,82,2,0.5074626865671642,75.0,144.0
20222023,Logan Brown,58,110,168,30,2,0.34523809523809523,180.0,160.0
20222023,Radek Faksa,309,243,552,81,2,0.5597826086956522,17.0,86.0
20222023,Juuso Parssinen,156,155,311,45,2,0.5016077170418006,80.0,125.0
20222023,Connor Dewar,222,281,503,81,2,0.441351888667992,153.0,107.0
20222023,Curtis Lazar,140,132,272,49,2,0.5147058823529411,61.0,131.0
20222023,Nicklas Backstrom,259,255,514,39,2,0.5038910505836576,79.0,98.0
20222023,Brayden Point,417,405,822,82,2,0.5072992700729927,76.0,64.0
20222023,Dylan Gambrell,138,168,306,60,2,0.45098039215686275,144.0,132.0
20222023,David Gustafsson,103,106,209,46,2,0.49282296650717705,93.0,143.0
20222023,Shane Pinto,449,413,862,82,2,0.5208816705336426,53.0,57.0
20222023,Pavel Zacha,134,162,296,82,2,0.4527027027027027,140.0,134.0
20222023,Mason McTavish,307,418,725,80,2,0.42344827586206896,165.0,88.0
20222023,J.T. Miller,487,399,886,81,2,0.5496613995485328,25.0,52.0
20222023,Scott Laughton,509,568,1077,78,2,0.4726090993500464,119.0,44.0
20222023,Tomas Nosek,354,243,597,66,2,0.592964824120603,6.0,76.0
20222023,Jaden Schwartz,73,84,157,71,2,0.46496815286624205,129.0,156.0
20222023,Jack McBain,370,470,840,82,2,0.44047619047619047,154.0,70.0
20222023,Jamie Benn,520,345,865,82,2,0.6011560693641619,4.0,41.0
20222023,Tommy Novak,179,223,402,51,2,0.44527363184079605,148.0,119.0
20222023,Kevin Stenlund,280,246,526,54,2,0.532319391634981,45.0,93.0
20222023,Dylan Larkin,737,618,1355,80,2,0.5439114391143911,31.0,10.0
20222023,Nick Bjugstad,530,578,1108,78,2,0.47833935018050544,108.0,39.0
20222023,Charlie Coyle,536,483,1019,82,2,0.5260058881256133,50.0,37.0
20222023,Pontus Holmberg,93,126,219,37,2,0.4246575342465753,163.0,148.0
20222023,Ben Meyers,96,91,187,39,2,0.5133689839572193,65.0,145.0
20222023,Nico Sturm,491,389,880,74,2,0.5579545454545455,18.0,50.0
20222023,Alex Wennberg,627,748,1375,82,2,0.456,137.0,25.0
20222023,Nick Suzuki,663,738,1401,82,2,0.4732334047109208,118.0,19.0
20222023,Sheldon Dries,235,236,471,63,2,0.4989384288747346,82.0,105.0
20222023,Nathan Walker,95,82,177,56,2,0.536723163841808,39.0,146.0
20222023,Jake Leschyshyn,118,115,233,35,2,0.5064377682403434,77.0,138.0
20222023,Lane Pederson,77,73,150,27,2,0.5133333333333333,66.0,155.0
20222023,Ryan O'Reilly,499,396,895,53,2,0.5575418994413408,19.0,49.0
20222023,Sam Lafferty,248,237,485,70,2,0.511340206185567,68.0,101.0
20222023,Martin Necas,11,22,33,15,3,0.3333333333333333,79.0,59.0
20222023,Brett Howden,14,19,33,22,3,0.42424242424242425,67.0,58.0
20222023,Ivan Barbashev,23,19,42,22,3,0.5476190476190477,25.0,51.0
20222023,Roope Hintz,71,62,133,19,3,0.5338345864661654,32.0,26.0
20222023,Ryan Hartman,25,35,60,5,3,0.4166666666666667,68.0,50.0
20222023,Casey Cizikas,31,31,62,6,3,0.5,40.0,48.0
20222023,Ryan Nugent-Hopkins,19,24,43,12,3,0.4418604651162791,63.0,55.0
20222023,Lars Eller,49,26,75,7,3,0.6533333333333333,2.0,36.0
20222023,Jordan Eberle,19,15,34,14,3,0.5588235294117647,18.0,55.0
20222023,Patrice Bergeron,52,22,74,3,3,0.7027027027027027,1.0,34.0
20222023,Pierre-Luc Dubois,52,37,89,5,3,0.5842696629213483,13.0,34.0
20222023,Colin White,40,40,80,21,3,0.5,40.0,43.0
20222023,Max Domi,72,56,128,19,3,0.5625,17.0,25.0
20222023,Yanni Gourde,94,108,202,14,3,0.46534653465346537,54.0,13.0
20222023,Matty Beniers,59,93,152,14,3,0.3881578947368421,73.0,31.0
20222023,Chandler Stephenson,188,164,352,22,3,0.5340909090909091,31.0,2.0
20222023,Steven Stamkos,21,36,57,6,3,0.3684210526315789,76.0,53.0
20222023,Matt Boldy,28,33,61,6,3,0.45901639344262296,57.0,49.0
20222023,Mika Zibanejad,63,68,131,7,3,0.48091603053435117,47.0,28.0
20222023,Connor McDavid,73,78,151,12,3,0.48344370860927155,45.0,24.0
20222023,Brock Nelson,31,34,65,6,3,0.47692307692307695,48.0,48.0
20222023,Aleksander Barkov,225,215,440,21,3,0.5113636363636364,39.0,1.0
20222023,Vincent Trocheck,50,56,106,7,3,0.4716981132075472,51.0,35.0
20222023,Jack Hughes,23,24,47,12,3,0.48936170212765956,42.0,51.0
20222023,Jordan Staal,164,147,311,15,3,0.5273311897106109,34.0,4.0
20222023,Mikko Rantanen,45,24,69,7,3,0.6521739130434783,3.0,39.0
20222023,Phillip Danault,46,55,101,6,3,0.45544554455445546,58.0,38.0
20222023,Nicolas Roy,129,133,262,22,3,0.49236641221374045,41.0,7.0
20222023,Sam Reinhart,94,138,232,21,3,0.4051724137931034,72.0,13.0
20222023,Barclay Goodrow,28,30,58,7,3,0.4827586206896552,46.0,49.0
20222023,Derek Stepan,42,39,81,11,3,0.5185185185185185,37.0,42.0
20222023,Eric Staal,44,56,100,21,3,0.44,65.0,40.0
20222023,Ryan O'Reilly,93,80,173,11,3,0.5375722543352601,29.0,14.0
20222023,Morgan Geekie,36,44,80,13,3,0.45,60.0,46.0
20222023,Mark Scheifele,22,22,44,4,3,0.5,40.0,52.0
20222023,Leon Draisaitl,120,98,218,12,3,0.5504587155963303,23.0,8.0
20222023,Gabriel Vilardi,22,27,49,5,3,0.4489795918367347,61.0,52.0
20222023,Anthony Cirelli,52,65,117,6,3,0.4444444444444444,62.0,34.0
20222023,Anze Kopitar,75,68,143,6,3,0.5244755244755245,35.0,22.0
20222023,Michael McLeod,91,69,160,12,3,0.56875,14.0,15.0
20222023,Pavel Zacha,45,48,93,7,3,0.4838709677419355,44.0,39.0
20222023,Tomas Nosek,55,36,91,7,3,0.6043956043956044,8.0,33.0
20222023,Auston Matthews,81,72,153,11,3,0.5294117647058824,33.0,21.0
20222023,Stefan Noesen,22,35,57,15,3,0.38596491228070173,74.0,52.0
20222023,John Tavares,82,48,130,11,3,0.6307692307692307,4.0,20.0
20222023,Joe Pavelski,81,62,143,14,3,0.5664335664335665,15.0,21.0
20222023,Adam Lowry,34,36,70,5,3,0.4857142857142857,43.0,47.0
20222023,Wyatt Johnston,38,55,93,19,3,0.40860215053763443,71.0,45.0
20222023,Radek Faksa,60,39,99,19,3,0.6060606060606061,7.0,30.0
20222023,Connor Dewar,18,31,49,6,3,0.3673469387755102,77.0,56.0
20222023,Brayden Point,23,26,49,6,3,0.46938775510204084,52.0,51.0
20222023,Kevin Stenlund,20,37,57,5,3,0.3508771929824561,78.0,54.0
20222023,Charlie Coyle,62,48,110,7,3,0.5636363636363636,16.0,29.0
20222023,Alex Wennberg,84,114,198,14,3,0.42424242424242425,67.0,19.0
20222023,Bo Horvat,71,66,137,6,3,0.5182481751824818,38.0,26.0
20222023,Erik Haula,86,69,155,12,3,0.5548387096774193,19.0,17.0
20222023,Teddy Blueger,8,22,30,6,3,0.26666666666666666,81.0,60.0
20222023,Nick Bjugstad,89,82,171,12,3,0.52046783625731,36.0,16.0
20222023,William Karlsson,168,141,309,22,3,0.5436893203883495,27.0,3.0
20222023,Ryan Donato,19,39,58,14,3,0.3275862068965517,80.0,55.0
20222023,Luke Glendening,84,56,140,17,3,0.6,10.0,19.0
20222023,Jaden Schwartz,38,32,70,14,3,0.5428571428571428,28.0,45.0
20222023,Jamie Benn,111,67,178,17,3,0.6235955056179775,5.0,9.0
20222023,Sebastian Aho,101,112,213,15,3,0.47417840375586856,49.0,11.0
20222023,Ryan McLeod,64,53,117,12,3,0.5470085470085471,26.0,27.0
20222023,Jesperi Kotkaniemi,63,90,153,15,3,0.4117647058823529,69.0,28.0
20222023,Sam Bennett,102,170,272,20,3,0.375,75.0,10.0
20222023,Tyler Seguin,85,74,159,19,3,0.5345911949685535,30.0,18.0
20222023,Nico Hischier,137,111,248,12,3,0.5524193548387096,22.0,5.0
20222023,David Krejci,18,26,44,4,3,0.4090909090909091,70.0,56.0
20222023,Jean-Gabriel Pageau,62,51,113,6,3,0.5486725663716814,24.0,29.0
20222023,Frederick Gaudreau,48,61,109,6,3,0.44036697247706424,64.0,37.0
20222023,Nathan MacKinnon,56,45,101,7,3,0.5544554455445545,20.0,32.0
20222023,J.T. Compher,45,50,95,7,3,0.47368421052631576,50.0,39.0
20222023,Nicholas Paul,43,30,73,6,3,0.589041095890411,11.0,41.0
20222023,Sam Steel,36,46,82,5,3,0.43902439024390244,66.0,46.0
20222023,Paul Stastny,74,52,126,15,3,0.5873015873015873,12.0,23.0
20222023,Filip Chytil,39,25,64,7,3,0.609375,6.0,44.0
20222023,Jack Eichel,130,152,282,22,3,0.46099290780141844,56.0,6.0
20222023,David Kampf,72,58,130,11,3,0.5538461538461539,21.0,25.0
20222023,Anton Lundell,100,116,216,21,3,0.46296296296296297,55.0,12.0
20222023,Ty Dellandrea,28,32,60,15,3,0.4666666666666667,53.0,49.0
20222023,Pierre-Edouard Bellemare,38,25,63,6,3,0.6031746031746031,9.0,45.0
20222023,Alex Newhook,15,18,33,7,3,0.45454545454545453,59.0,57.0
